1	ADJ
1	DET
1	NC
10	ADJ
10	DET
100	DET
100	PRO
1000	DET
100000	DET
107	PRO
11	ADJ
11	DET
110	DET
110	PRO
11000	PRO
118	DET
12	ADJ
12	DET
120	DET
120000	DET
12150	DET
1235	DET
125	DET
12500	DET
12h30	NC
13	ADJ
13	DET
130000	ADJ
130000	DET
14	ADJ
14	DET
140	DET
142	DET
143	DET
1441	DET
15	ADJ
15	DET
150	DET
1500	DET
150000	DET
15h30	NC
16	ADJ
16	DET
160	DET
169	DET
16h40	NC
16h50	NC
17	ADJ
17	DET
17000	ADJ
172	DET
176	DET
1789	NC
17h30	NC
17h40	NC
18	DET
188	DET
19	DET
190	DET
192	DET
1950	NC
1956	NC
1958	NC
1961	NC
1962	NC
1964	NC
1967	NC
1968	NC
1970	NC
1975	NC
1976	NC
1978	NC
1979	NC
1980	NC
1981	NC
1982	NC
1983	NC
1984	NC
1985	NC
1986	NC
1987	NC
1988	NC
1989	NC
1990	NC
1991	NC
1992	NC
1993	NC
1994	NC
1995	NC
1996	NC
199920	DET
19h55	NC
2	ADJ
2	DET
20	ADJ
20	DET
200	DET
2000	NC
20000	DET
200000	PRO
2028	DET
21	ADJ
210	DET
213	DET
22	ADJ
220000	PRO
2251	DET
23	ADJ
24	ADJ
24	DET
25	ADJ
25	DET
250	DET
25000	DET
26	ADJ
26	DET
27	ADJ
271	DET
2720000	DET
275	DET
28	ADJ
28	DET
2806	DET
3	ADJ
3	DET
3	NC
30	ADJ
30	DET
30000	DET
30000	PRO
300000	PRO
305	DET
3090	DET
31	ADJ
310	DET
31000	DET
32	DET
3200	PRO
34	DET
35	DET
350	DET
35000	DET
38	DET
390	DET
3900	DET
4	ADJ
4	DET
40	ADJ
40	DET
400	DET
4000	DET
40000	DET
400000	DET
41	DET
43	ADJ
43	DET
441000	DET
446	DET
45	DET
47	DET
48	DET
49	DET
4h30	NC
5	ADJ
5	DET
5	NPP
50	DET
500	ADJ
500	DET
50000	DET
50000	PRO
500000	PRO
503	ADJ
506	ADJ
509	DET
51	DET
52	DET
54	DET
5500	DET
550000	DET
56	DET
57	DET
57000	ADJ
5759	ADJ
588	DET
59	DET
5h30	NC
6	ADJ
6	DET
6	NPP
60	ADJ
60	DET
60000	DET
62	DET
620	DET
62000	DET
632	DET
65	DET
66	DET
68	DET
69	DET
696	DET
6h20	NC
6h30	NC
7	ADJ
7	DET
70	DET
700	ADJ
700	DET
7000	DET
70000	DET
700000	ADJ
700000	DET
71	DET
7400	ADJ
75	DET
75000	DET
7719	ADJ
7720	ADJ
775	DET
7h20	NC
8	ADJ
8	DET
8	PRO
80	ADJ
80	DET
800	DET
80000	DET
847	DET
85	DET
9	ADJ
9	DET
90	ADJ
90	DET
900000	PRO
91	NC
915000	PRO
92	ADJ
92	NC
9500	DET
970	ADJ
A	NC
A	P
ACOSS	NPP
AGF	NPP
AGRR	NPP
ALAIN	NPP
ALLEMAGNE	NPP
ANPE	NC
APEC	NPP
ATR	NPP
AUTOMATISATION	NC
AVIA	NPP
A_contrario	ADV
A_peine	ADV
A_telle_enseigne_que	CS
Abel	NPP
Abondamment	ADV
Abou	NPP
Acteur	NC
Actuellement	ADV
Adam	NPP
Agence	NC
Agents	NC
Agnelli	NPP
Agricole	ADJ
Ain	NPP
Ainsi	ADV
Ainsi_que	CS
Air	NC
Airbus	NC
Airbus	NPP
Airlines	ET
Airways	ET
Alain	NPP
Albert	NPP
Alduy	NPP
All	ET
Allemagne	NPP
Allemands	NC
Alors_que	CS
Alsace	NPP
Amadeus	NPP
Anciennement	ADV
Anciens	NPP
Andersen	NPP
Anglais	NC
Angleterre	NPP
Anne	NPP
Antenne	NC
Antoine	NPP
Argentine	NPP
Arkadi	NPP
Arnaud	NPP
Arthur	NPP
Atlantique	NPP
Attali	NPP
Au_contraire	ADV
Au_cours_de	P
Au_cours_des	P
Au_demeurant	ADV
Au_mieux	ADV
Au_total	ADV
Aube	NPP
Aubert	NPP
Aubry	NPP
Auch	NPP
Aucun	PRO
Aucune	DET
Auguste	NPP
Auparavant	ADV
Aussi	ADV
Austrian	ET
Automatisation	NC
Autre	ADJ
Autrement_dit	ADV
Avant	P
Avec	P
Aveyron	NPP
Avez	V
Avia	NPP
Avignon	NPP
Ayant	VPR
B	NC
BCCI	NPP
BERD	NPP
BNCI	NPP
BNP	NPP
BP	NPP
BRUXELLES	NPP
BSN	NPP
BUE	NPP
Balcerowicz	NPP
Balfour	NPP
Balfour_Beatty_Projects_and_engineering_Ltd	NPP
Baltica	NPP
Bank	ET
Banque	NC
Barberis	NPP
Barre	NPP
Baylet	NPP
Beatty	NPP
Belges	NPP
Belgique	NPP
Bercy	NPP
Bergougnoux	NPP
Berlusconi	NPP
Bernard	NPP
Besnier	NPP
Bettino	NPP
Bianco	NPP
Bien_que	CS
Bilan	NC
Bisounours	NPP
Blanc	NPP
Blanche	ADJ
Board	ET
Bon	ADJ
Bongrain	NPP
Bonn	NPP
Bordeaux	NPP
Bordelaise	NPP
Boris	NPP
Born	NPP
Boulevard	NC
Bourges	NPP
Bourse	NC
Bourses	NC
Bouter	VINF
Boutet	NPP
Boyer	NPP
Bref	ADV
Brent	NPP
Brest	NPP
Bretagne	NPP
Bridel	NPP
Britanniques	NC
British	ET
British	NPP
Brothers	NPP
Bruxelles	NPP
Buchanan	NPP
Budapest	NPP
Bull	NPP
Bush	NPP
CBI	NPP
CBV	NPP
CED	NPP
CEE	NPP
CERC	NPP
CFAO	NPP
CFDT	NPP
CFE	NPP
CGC	NPP
CGT	NPP
CIC	NPP
CIRI	NPP
CLT	NPP
CNJA	NPP
CNRS	NC
COB	NPP
CSA	NC
CSA	NPP
CSF	NPP
CSG	NPP
CSMF	NPP
Caisse	NC
Caisses	NC
Calais	NPP
Cambridge	ET
Canaille	NC
Canal	NPP
Canal_Plus	NPP
Capitalistique	ADJ
Caprice	NPP
Car	CC
Castelsarrasin	NPP
Cavaillon	NPP
Ce	CLS
Ce	DET
Ce	PRO
Cela	PRO
Centre	NPP
Cependant	ADV
Certainement_pas	ADV
Certains	PRO
Certes	ADV
Ces	DET
Cet	DET
Cette	DET
Chaix	NPP
Chalvon	NPP
Chamard	NPP
Changez	V
Charles	NPP
Chirac	NPP
Cholet	NPP
Christian	NPP
Chrysler	NPP
Cinq	NPP
Cinq	PRO
City	ET
Claude	NPP
Coeur	NC
Colombes	NPP
Comme	CS
Comme	P
Comme_si	CS
Comment	ADVWH
Commentant	VPR
Commission	NC
Communication	NC
Compagnie	NC
Compte_tenu_des	P
Confederation_of_British_Industry	ET
Confirmant	VPR
Conjoncture	NC
Conseil	NC
Conseil	NPP
Conseiller	NC
Consommation	NC
Constitution	NC
Consumer	NPP
Corset	NPP
Cosby	NPP
Cosson	NPP
Cottave	NPP
Council	ET
Cour	NC
Cousteau	NC
Craxi	NPP
Cresson	NPP
Croix	NPP
DIVISION	NC
DM	NC
DOM	NPP
DRH	NC
Daniel	NPP
Dans	P
Dans_ces_conditions	ADV
Dans_le_cadre_de	P
Dans_le_cas_des	P
Dans_un_premier_temps	ADV
Dassault	NPP
Dauzier	NPP
David	NPP
De	P
De_la_sorte	ADV
De_plus	ADV
De_semaine_en_semaine	ADV
Decampse	NPP
Delaporte	NPP
Demain	ADV
Denis	NPP
Denvers	NPP
Depuis	P
Dernier	ADJ
Des	DET
Deutsche	ET
Deutsche	NPP
Deux	DET
Devant	P
Development	ET
Deverloy	NPP
Deverra	NPP
Dhabi	NPP
Dieux	NC
Difficile	ADJ
Digne	NPP
Dijon	NPP
Discipline	NC
Dix	DET
Dnes	NPP
Docks	NC
Dominique	NPP
Dommage	ADV
Dommage	NC
Donald	NPP
Donnant	VPR
Dordogne	NPP
Douze	DET
Douze	NC
Dreyfus	NPP
Drian	NPP
Du_Tertre	NPP
Dumas	NPP
Dumon	NPP
Dunkel	NPP
Dupont	NPP
EDF	NPP
ENA	NPP
ET	CC
Eaux	NC
Echiquier	NPP
Economic	ET
Economie	NC
Edith	NPP
Efforts	NC
Egor	NPP
Electronics	NPP
Elle	CLS
Elle_et_Vire	NPP
Elles	CLS
Eltsine	NPP
En	P
En_attendant	ADV
En_cas_de	P
En_ce_qui_concerne	P
En_effet	ADV
En_fonction_de	P
En_hausse	ADV
En_moyenne	ADV
En_outre	ADV
En_revanche	ADV
Encore	ADV
Energy	ET
Enfin	ADV
Ensemble	ADV
Ensuite	ADV
Entre	P
Entremont	NPP
Eric	NPP
Erreur	NC
Escande	NPP
Espagne	NPP
Est	NC
Est	NPP
Est	V
Et	CC
Et_puis	CC
Etat	NC
Etat	NPP
Etats	NC
Eurojob	NPP
Europe	NPP
European	ET
Evidemment	ADV
Exemple	NC
Exor	NPP
Eysymontt	NPP
F	NC
FAMILIALE	ADJ
FEHAP	NPP
FIEHP	NPP
FLEXIBLE	ADJ
FMI	NPP
FNSEA	NPP
FO	NPP
FR	NC
FR3	NPP
Fabius	NPP
Familles	NC
Farnoux	NPP
Fauroux	NPP
Fausse	ADJ
Faute_de	P
Fiat	NPP
Fin	NC
Fininvest	NPP
Fitzpatrick	NPP
Floch	NPP
Fondation	NC
Force	NPP
Ford	NPP
Fourtou	NPP
France	NPP
Francfort	NPP
Francis	NPP
Franz	NPP
Frederick	NPP
Fronta	NPP
GAN	NPP
GATT	NPP
GIAT	NPP
GIE	NPP
GUF	NPP
Gaboriau	NPP
Gandois	NPP
Gaz	NC
General	NPP
Geneval	NPP
George	NPP
Georges	NPP
Gers	NPP
Giancardo	NPP
Giga	NPP
Gilles	NPP
Girard	NPP
Giscard	NPP
Giuly	NPP
Globalement	ADV
Goeudevert	NPP
Goldorak	NC
Golfe	NC
Gomez	NPP
Gorbatchev	NPP
Grandin	NPP
Gros	NPP
Grunelius	NPP
Guitton	NPP
Gutmann	NPP
Gyver	NPP
HLM	NC
Haberer	NPP
Hachette	NPP
Hafnia	NPP
Harold	NPP
Hata	NPP
Haute	ADJ
Heilbronner	NPP
Helmut	NPP
Henri	NPP
Hersant	NPP
Heseltine	NPP
Honda	NPP
Hongrie	NPP
Hors	P
Hubert	NPP
Huit	DET
IDC	NPP
IFIL	NPP
IG	NPP
INSEE	NPP
Iberia	NPP
Il	CLS
Il_y_a	P
Il_y_a	V
Illoud	NPP
Ils	CLS
Image	V
In_fine	ADV
Inaugurant	VPR
Indigence	NC
Industrial_bank_of_Japan	NPP
Industrie	NPP
Industries	NC
Inspecteur	NC
Institute	NC
Inter	ADJ
Intercontinental	NPP
Intervenant	VPR
Italie	NPP
Italiens	NC
Iveco	NPP
Izvestia	NPP
J	NC
JEF	NPP
Jack	NPP
Jacob	NPP
Jacobs	NPP
Jacques	NPP
Jan	NPP
Janeiro	NPP
Japon	NC
Japon	NPP
Japonais	NC
Je	CLS
Jean	NPP
Jerzy	NPP
John	NPP
Journal	NC
Joxe	NPP
Juillet	NPP
Kahn	NPP
Karl	NPP
Karmitz	NPP
Keller	NPP
LA	DET
LEBAUBE	NPP
LIMOGES	NPP
LRM	NPP
LUXEMBOURG	NPP
La	DET
Lafont	NPP
Laigneau	NPP
Lajeunesse	NPP
Lamont	NPP
Lamotte	NPP
Lang	NPP
Laurent	NPP
Laval	NPP
Le	DET
Leclerc	NPP
Ledru	NPP
Lefebvre	NPP
Lequel	PROWH
Les	DET
Leszek	NPP
Lettre	NC
Leur	DET
Lever	NPP
Liaz	NPP
Liliane	NPP
Lille	NPP
Lin	NPP
Lion	NPP
Lire	VINF
Loin_de	P
Londres	NPP
Lorentz	NPP
Lorraine	NPP
Lors_de	P
Louis	NPP
Lourdes	NPP
Lufthansa	NPP
Luxembourg	NPP
Lyon	NPP
M	NPP
MBB	NPP
MITI	NPP
MK2	NPP
MMB	NPP
MOSCOU	NPP
Maastricht	NPP
Mac	NPP
Macmillan	NPP
Madinier	NPP
Maillot	NPP
Mainishi	NPP
Mais	CC
Maison	NC
Major	NPP
Malheureusement	ADV
Mamie	NPP
Manche	NC
Mandag	ET
Margaux	NPP
Marie	NPP
Mariet	NPP
Marin	NPP
Maritime	NPP
Marne	NPP
Marseillaise	NPP
Martine	NPP
Martre	NPP
Marx	NPP
Matignon	NPP
Matouk	NPP
Matra	NPP
Matuikhin	NPP
Maurice	NPP
Maurisson	NPP
Mauroy	NPP
Mauvais	ADJ
Maxwell	NPP
Mayenne	NC
Mazda	NPP
Mazeaud	NPP
Me	NC
Meisonnier	NPP
Meissonnier	NPP
Mellick	NPP
Mentzelopoulos	NPP
Mercedes	NPP
Mermaz	NPP
Metall	NPP
Mettant	VPR
Meule	NC
Mexique	NPP
Michael	NPP
Michel	NPP
Milan	NPP
Minitel	NC
Mireille	NPP
Mis	V
Mitsubishi	NPP
Mitterrand	NPP
Miyazawa	NPP
Mlada	NPP
Mme	NC
Mme	NPP
Monde	NPP
Monod	NPP
Monopoly	NPP
Moravie	NPP
Morgen	ET
Morin	NPP
Morlaix	NPP
Moscou	NPP
Motors	NPP
Moulard	NPP
Moulins	NC
Mourmelon	NPP
Munich	NPP
NEDC	NPP
NHS	NPP
Nam	NPP
Nantes	NPP
Naville	NPP
Neddy	NPP
Nicholls	NPP
Nickelodeon	NPP
Nicolas	NPP
Nippon	ET
Non	ADV
Nord	NPP
Norman	NPP
Normand	NPP
Normandie	NPP
Northern	NPP
Notre	DET
Nounours	NPP
Nous	CLS
Nouveau	ADJ
Nouvel	ADJ
Nouvelle	ADJ
Nova	ET
Nul	DET
OCDE	NC
OP	NPP
OPA	NC
OPFI	NPP
OPZZ	NPP
OS	NPP
Objectif	NC
Observateur	NC
Office	NC
Olszewski	NPP
Ominco	NPP
On	CLS
Onze	DET
Or	CC
Or	NC
Orsay	NPP
Ou	CC
Ouest	NC
Ouest	NPP
Oui	ADV
Outre	P
Oxbridge	ET
Oxford	ET
PAC	NPP
PAP	NPP
PDG	NC
PENDANT	P
PIB	NC
PME	NC
PNB	NC
PRAGUE	NPP
PS	NPP
PUF	NPP
P_et_T	NPP
Pache	NPP
Paix	NC
Par	P
Parfois	ADV
Paribas	NPP
Paris	NPP
Parlement	NC
Parmi	P
Partant	VPR
Parti	NC
Pascal	NPP
Pasqua	NPP
Pat	NPP
Pau	NPP
Pauvre	ADJ
Pauvres	ADJ
Pechiney	NPP
Pellerin	NPP
Pen	NPP
Pendant	P
Perrier	NPP
Personne	PRO
Perte	NC
Petit	ADJ
Petroleum	NPP
Peu	ADV
Peyrelevade	NPP
Philippe	NPP
Pierre	NPP
Pimprenelle	NPP
Pis	ADV
Plan	NC
Plus	ADV
Plus_que	ADV
Pollena	NPP
Pologne	NPP
Polska	NPP
Pons	NPP
Ponthieux	NPP
Post	NPP
Poste	NC
Pour	P
Pourquoi	ADVWH
Pourtant	ADV
Prague	NPP
Prigent	NPP
Principal	ADJ
Prochain	ADJ
Professeur	NC
Projects	NPP
Propos	NC
Puis	CC
Quai	NC
Quand	ADVWH
Quand	CS
Quant_au	P
Quant_aux	P
Quatre	DET
Que	CS
Que	PROWH
Quelle	DETWH
Quelles	PROWH
Quelques	DET
Quels	DETWH
Qui	PROREL
Qui	PROWH
Quoi	PROWH
R	NPP
RATP	NPP
RDA	NPP
RFA	NPP
RMI	NC
RPR	NC
RVI	NPP
Rallye	NPP
Rausch	NPP
Ray	NPP
Raymond	NPP
Recette	NC
Reconnaissant	VPR
Reliquet	NPP
Renault	NPP
Resserrant	VPR
Review	ET
Reynier	NPP
Riboud	NPP
Rio	NPP
Rivoli	NPP
Robert	NPP
Roland	NPP
Rollat	NPP
Rombas	NPP
Royal	NPP
Rue	NC
Ruhr	NPP
Rungis	NC
Russes	NC
Russie	NPP
SA	NC
SARI	NPP
SAS	NPP
SEM	NPP
SGF	NPP
SGS	NPP
SIVP	NPP
SME	NPP
SMIC	NC
SNCF	NC
SOFRES	NPP
Saint	ADJ
Salinas	NPP
Salomon	NPP
Samuel	NPP
Sanofi	NPP
Sans	P
Sans_doute	ADV
Santilli	NPP
Sapin	NPP
Sartrouville	NPP
Satory	NPP
Saviem	NPP
Scalbert	NPP
Scandinavie	NPP
Schweitzer	NPP
Selon	P
Sept	DET
Serait	V
Seule	ADJ
Seulement	ADV
Seuls	ADJ
Seydoux	NPP
Sharry	NPP
Si	CS
Silvio	NPP
Singapore	ET
Sinon	ADV
Sir	NC
Skandia	NPP
Skoda	NPP
Smith	NPP
Socpresse	NPP
Sodiaal	NPP
Solution	NC
Son	DET
Sophie	NPP
Souchon	NPP
Sous	P
Statistical	ET
Stern	NPP
Strauss	NPP
Street	ET
Suchard	NPP
Suez	NPP
Super	NC
Supposons	V
Sur	P
Surtout	ADV
TF	NC
TGV	NC
TOKYO	NPP
TOM	NPP
TRAVAIL	NC
TUC	NPP
TV	NC
TVA	NC
Tapie	NPP
Tardivon	NPP
Tarzan	NPP
Tatra	NPP
Ted	NPP
Telecom	NPP
Teochew	NPP
Teulade	NPP
Thatcher	NPP
The	ET
Thomas	NPP
Thomson	NPP
Tokyo	NPP
Tonnerre	NPP
Totalisant	VPR
Toujours	ADV
Toulouse	NPP
Touraine	NPP
Tout	ADJ
Tout	ADV
Tout	PRO
Tout_au_long_de	P
Toutefois	ADV
Toyota	NPP
Transparence	NC
Trichet	NPP
Trois	DET
Troyes	NPP
Trust	NPP
Tu	CLS
U	NC
UAP	NC
UDC	NPP
UDF	NPP
UEM	NPP
UHP	NPP
ULN	NPP
UNEDIC	NPP
URSS	NPP
URSSAF	NPP
Un	DET
Une	DET
Une	NPP
Unilever	NPP
Union	NC
Union	NPP
Uruguay	NPP
VARSOVIE	NPP
VEV	NPP
VMTV	NPP
Valence	NPP
Varsovie	NPP
Vaucluse	NPP
Velasquez	NPP
Vendredi	NC
Verdun	NPP
Veszprem	NPP
Victoire	NPP
Vie	NC
Vincent	NPP
Vingt_et_une	DET
Vnesheconombank	NPP
Voici	V
Volkswagen	NPP
Volski	NPP
Volvo	NPP
Vous	CLS
Vu	VPP
Wall	ET
Washington	NPP
Weber	NPP
Werner	NPP
Worms	NPP
Worms_et_Cie	NPP
XIIIe	NPP
XIX	NPP
Yoplait	NPP
Youppie	I
Yvelines	NPP
Yves	NPP
Zorro	NPP
Zygomusic	NPP
a	V
a_posteriori	ADJ
a_priori	ADV
abandon	NC
abandonnant	VPR
abattement	NC
aboutira	V
aboutissant	VPR
abri	NC
absence	NC
absent	ADJ
absorption	NC
absoudre	VINF
abuser	VINF
accalmie	NC
accent	NC
accentuent	V
acceptable	ADJ
acceptant	VPR
acceptation	NC
accepter	VINF
acceptera	V
accepteraient	V
accepterait	V
accession	NC
accident	NC
accidents	NC
accompagnement	NC
accompagnent	V
accord	NC
accordait	V
accordant	VPR
accorder	VINF
accords	NC
accrochages	NC
accroissement	NC
accrue	ADJ
accrues	ADJ
accueil	NC
accueillie	VPP
accueillies	VPP
accueillir	VINF
accuse	V
acharnement	NC
acharner	VINF
achat	NC
achats	NC
achemine	V
acheminer	VINF
acheter	VINF
acheteurs	NC
achever	VINF
acier	NC
acquis	ADJ
acquis	VPP
acquise	ADJ
acquisitions	NC
acquitte	V
acquittent	V
acte	NC
actes	NC
acteur	NC
acteurs	NC
actif	ADJ
actif	NC
actifs	NC
action	NC
actionnaire	NC
actionnaires	NC
actionnariat	NC
actions	NC
active	ADJ
actuel	ADJ
actuelle	ADJ
actuellement	ADV
actuelles	ADJ
actuels	ADJ
adaptation	NC
adapter	VINF
adjoint	ADJ
adjudications	NC
admet	V
admettent	V
admettre	VINF
administrateur	NC
administrateurs	NC
administratifs	ADJ
administration	NC
administrative	ADJ
administratives	ADJ
admirait	V
admirent	VS
admis	VPP
adolescents	NC
ados	NC
adresser	VINF
adulte	NC
adultes	NC
advienne	VS
affaibli	VPP
affaiblir	VINF
affaire	NC
affaires	NC
affectant	VPR
affichant	VPR
afficher	VINF
affirmant	VPR
affirme	V
affirment	V
affirmer	VINF
affluence	NC
affranchir	VINF
affronter	VINF
afin	CS
afin	P
afin_de	P
agence	NC
agent	NC
agents	NC
aggravation	NC
agi	VPP
agir	VINF
agira	V
agirait	V
agissant	VPR
agisse	VS
agit	V
agitation	NC
agression	NC
agressive	ADJ
agricole	ADJ
agricoles	ADJ
agriculteur	NC
agriculteurs	NC
agriculture	NC
agroalimentaire	ADJ
agroalimentaire	NC
agroalimentaires	ADJ
ai	V
aide	NC
aider	VINF
aides	NC
aient	VS
aimeraient	V
ainsi	ADV
ainsi_que	CC
ainsi_que	CS
air	NC
ait	VS
ajoutant	VPR
ajoute	V
ajoutent	V
ajouter	VINF
ajouterait	V
ajoutons	V
alarme	NC
alarmer	VINF
alcool	NC
alcoolisme	NC
alentours	NC
alimentaires	ADJ
alimentant	VPR
alimentation	NC
allaient	V
allait	V
allaitante	ADJ
allant	VPR
allemand	ADJ
allemande	ADJ
allemands	ADJ
aller	VINF
alliance	NC
allier	VINF
allocation	NC
allocations	NC
allongement	NC
allons	V
alors	ADV
alors_que	CS
alourdir	VINF
amalgame	NC
ambiance	NC
ambiante	ADJ
ambitions	NC
amende	NC
amendes	NC
amener	VINF
amer	ADJ
amical	ADJ
amicale	NC
amicalement	ADV
amicales	ADJ
amis	NC
amorcer	VINF
amorphe	ADJ
amples	ADJ
ampleur	NC
amplifient	V
amputation	NC
an	NC
anachronique	ADJ
analyse	NC
analyse	V
anarchique	ADJ
ancien	ADJ
ancienne	ADJ
anciennement	ADV
anciens	ADJ
anciens	NC
ancre	NC
and	ET
anglaise	ADJ
angle	NC
anicroches	NC
animation	NC
animations	NC
animaux	NC
animer	VINF
anniversaire	NC
annonce	NC
annonce	V
annoncerait	V
annonces	NC
annuel	ADJ
annuelles	ADJ
ans	NC
antenne	NC
anticipations	NC
anticiper	VINF
apaiser	VINF
apanage	NC
apparaissaient	V
apparaissent	V
appareil	NC
appareils	NC
apparemment	ADV
apparent	ADJ
apparente	ADJ
apparente	V
apparentent	VS
apparition	NC
appartenait	V
appartenu	VPP
appel	NC
appelle	V
application	NC
applique	V
appliquer	VINF
appliquera	V
apporte	V
apportent	V
apporter	VINF
apprentis	NC
apprentissage	NC
approbation	NC
approche	NC
approfondi	VPP
approfondie	ADJ
approfondissement	NC
approfondit	V
approprier	VINF
approuver	VINF
approvisionne	V
appuyer	VINF
aptitudes	NC
arbitrage	NC
arbitrages	NC
arbitre	NC
argent	NC
argentiers	NC
arguant	VPR
argument	NC
arguments	NC
armada	NC
armement	NC
armements	NC
armes	NC
arrange	V
arrivaient	V
arrivants	NC
arrondissement	NC
arrondit	V
article	NC
articles	NC
artificiellement	ADV
artisanat	NC
artisans	NC
ascension	NC
aspect	NC
aspiration	NC
assaut	NC
asservi	VPP
assez	ADV
assistait	V
assistance	NC
assistante	NC
assiste	V
assit	V
association	NC
associations	NC
associer	VINF
assorties	VPP
assouplissement	NC
assumant	VPR
assume	V
assumer	VINF
assurance	NC
assurances	NC
assure	V
assurer	VINF
assureur	NC
astuce	NC
astuces	NC
ateliers	NC
atout	NC
atouts	NC
atrophie	V
attachement	NC
attaquant	NC
atteignait	V
atteignent	V
atteindrait	V
atteindre	VINF
atteindront	V
atteint	ADJ
atteint	V
atteint	VPP
atteinte	NC
attend	V
attendant	VPR
attendre	VINF
attendu	VPP
attente	NC
attention	NC
atteste	V
attirer	VINF
attitude	NC
attractif	ADJ
attribuent	V
atypique	ADJ
au_bord_du	P
au_bout_de	P
au_cas_par_cas	ADV
au_cours_de	P
au_cours_des	P
au_cours_du	P
au_lendemain_de	P
au_lieu_des	P
au_lieu_du	P
au_moins	ADV
au_noir	ADV
au_nom_de	P
au_plus_fort_de	P
au_prix_de	P
au_quotidien	ADV
au_sein_de	P
au_sein_du	P
au_sens_de	P
au_soir	ADV
au_terme	P
au_titre_de	P
au_vu_des	P
aucun	DET
aucune	DET
audience	NC
audiovisuel	ADJ
audiovisuel	NC
audiovisuels	ADJ
audits	NC
augmentation	NC
augmentations	NC
augmente	V
augmenter	VINF
augmentera	V
augmenteront	V
augure	V
auparavant	ADV
aura	V
auraient	V
aurais	V
aurait	V
auront	V
aussi	ADV
aussi_bien	ADV
autant	ADV
auteur	NC
auteurs	NC
autogestion	NC
automates	NC
automatisation	NC
automne	NC
automobile	ADJ
automobile	NC
automobiles	ADJ
automobiles	NC
automobilistes	NC
autonomes	ADJ
autonomie	NC
autorisait	V
autorisant	VPR
autoritaire	ADJ
autoroute	NC
autoroutes	NC
autour_de	P
autour_du	P
autre	ADJ
autre	PRO
autrement	ADV
autres	ADJ
autres	PRO
avaient	V
avait	V
avances	NC
avant	P
avant_de	P
avantage	NC
avantagerait	V
avantages	NC
avec	P
avenants	NC
avenir	NC
aveu	NC
avez	V
aviation	NC
aviez	V
avionique	NC
avions	NC
avis	NC
aviser	VINF
avoir	NC
avoir	VINF
avons	V
avoue	V
avril	NC
axe	NC
axes	NC
ayant	VPR
bailleur	NC
baisse	NC
baisse	V
baisser	NC
baisser	VINF
baissera	V
baisses	NC
balbutiante	ADJ
bambins	NC
banal	ADJ
banane	NC
bancaire	ADJ
bancaires	ADJ
bande	NC
bank	ET
banlieue	NC
bannir	VINF
banque	NC
banques	NC
banquier	NC
banquiers	NC
bar	NC
barbarisants	ADJ
baril	NC
barils	NC
barrage	NC
barrages	NC
barrent	V
barrer	VINF
bas	ADJ
base	NC
bases	NC
bassin	NC
bataille	NC
batailles	NC
bateaux	NC
battant	VPR
battre	VINF
battu	VPP
baume	NC
beaucoup	ADV
beaucoup	PRO
belle	ADJ
belles	ADJ
berrichon	ADJ
besoin	NC
besoins	NC
beurre	NC
biais	NC
bien	ADJ
bien	ADV
bienfaits	NC
biens	NC
bienveillant	ADJ
bilan	NC
bilans	NC
blanchiment	NC
bleus	ADJ
bloc	NC
blocage	NC
blocages	NC
blocus	NC
blonde	ADJ
bloquant	VPR
bloque	V
bon	ADJ
bon_an_mal_an	ADV
bond	NC
bondi	VPP
bonne	ADJ
bonne	NC
bonnes	ADJ
bons	ADJ
boom	NC
bord	NC
bordelaise	ADJ
bouchant	VPR
bouche	NC
bouger	VINF
bougera	V
boulot	NC
bourse	NC
bout	NC
boutique	NC
boutiques	NC
branche	NC
branches	NC
brebis	NC
brefs	ADJ
bricolage	NC
brillants	ADJ
brise	V
britannique	ADJ
britanniques	ADJ
bruitages	NC
brun	ADJ
brusque	ADJ
brusquer	VINF
brut	ADJ
brut	NC
brutale	ADJ
bruts	ADJ
budget	NC
budgets	NC
bulletin	NC
bulletins	NC
bureaucratiques	ADJ
but	NC
bute	V
butoir	NC
cabinet	NC
cadre	NC
cadres	NC
cahier	NC
caisses	NC
calcul	NC
calculer	VINF
calculs	NC
calendrier	NC
calme	NC
calmer	VINF
camembert	NC
camion	NC
camionneurs	NC
camions	NC
camp	NC
campagne	NC
campagnes	NC
canadien	ADJ
canadien	NC
candidat	NC
candidats	NC
cantons	NC
cap	NC
capable	ADJ
capital	NC
capitale	NC
capitulation	NC
captifs	ADJ
car	CC
carbure	V
caricature	NC
carie	NC
carnets	NC
carte	NC
cas	NC
case	NC
castes	NC
catalogue	NC
catalogues	NC
catastrophe	NC
cause	NC
ce	CLO
ce	CLS
ce	DET
ce	PRO
cela	PRO
celle	PRO
celles	PRO
cellule	NC
celui	PRO
censure	NC
centaine	NC
centimes	NC
central	ADJ
centrale	ADJ
centrale	NC
centrales	ADJ
centraux	NC
centre	NC
centres	NC
centrifugeuse	NC
cependant	ADV
certain	ADJ
certaine	ADJ
certainement	ADV
certaines	ADJ
certaines	DET
certaines	PRO
certains	DET
certains	PRO
certes	ADV
ces	DET
cessant	VPR
cesse	V
cesser	VINF
cession	NC
cet	DET
cette	DET
ceux	PRO
chacun	PRO
chacune	PRO
chambardement	NC
chambre	NC
champ	NC
champs	NC
chance	NC
chancelante	ADJ
chancelier	NC
chances	NC
change	NC
changea	V
changement	NC
changements	NC
changent	V
changer	VINF
changes	NC
chantier	NC
chapitre	NC
chaque	DET
chaque_fois_que	CS
char	NC
charge	NC
chargeant	VPR
chargera	V
charges	NC
chars	NC
chars_de_combat	NC
charte	NC
charter	ET
chasse	NC
chauffeurs	NC
chef	NC
chefs	NC
chemin	NC
cher	ADJ
chercher	VINF
chercheraient	V
chercheront	V
chercheurs	NC
chevaliers	NC
chevelure	NC
chez	P
chics	ADJ
chien	NC
chiffre	NC
chiffres	NC
chimie	NC
chimiques	ADJ
choc	NC
chocolat	NC
choisi	VPP
choisiraient	V
choix	NC
choqua	V
chose	NC
choses	NC
chronique	ADJ
chronique	NC
chronotachygraphes	NC
chute	NC
ci	ADV
cinq	ADJ
cinq	DET
cinq	PRO
cinquante	DET
circonspection	NC
circonstances	NC
circuits	NC
circulaire	NC
circulation	NC
circuler	VINF
citaient	V
cite	V
citizen	ET
citoyen	NC
citoyens	NC
civil	ADJ
civiles	ADJ
clair	ADJ
claire	ADJ
clairement	ADV
clandestin	ADJ
clarification	NC
clarifient	V
classe	NC
classement	NC
classless_society	ET
clauses	NC
clients	NC
climat	NC
clips	NC
clique	NC
clivage	NC
coalition	NC
coeur	NC
cogestion	NC
collaborateur	NC
collaboration	NC
collecte	NC
collectifs	ADJ
collection	NC
collective	ADJ
collectivement	ADV
colonne	NC
combat	NC
combattre	VINF
combien	ADVWH
combler	VINF
commandes	NC
commandite	NC
comme	ADV
comme	CC
comme	CS
comme	P
comme_avant	ADV
comme_si	CS
commence	V
commencent	V
comment	ADVWH
commerce	ET
commerce	NC
commercial	ADJ
commerciale	ADJ
commerciales	ADJ
commercialisation	NC
commercialise	V
commerciaux	ADJ
commises	VPP
commissaire	NC
commissariat	NC
commission	NC
commissions	NC
commun	ADJ
communautaire	ADJ
communautaires	ADJ
commune	ADJ
communication	NC
communiquer	VINF
communiste	ADJ
communistes	ADJ
communs	ADJ
commutation	NC
compagnie	NC
comparative	ADJ
compare	V
compassion	NC
compensant	VPR
compensation	NC
compensatoires	ADJ
compenser	VINF
complaisance	NC
complet	ADJ
complexe	ADJ
complexes	ADJ
complexes	NC
complices	NC
comporte	V
comporterait	V
composante	NC
composite	ADJ
comprenaient	V
comprend	V
comprendre	VINF
compression	NC
compris	VPP
comprise	VPP
comprises	VPP
compromettent	V
compromettre	VINF
compromis	NC
comptables	ADJ
compte	NC
compte	V
compte_tenu_de	P
compte_tenu_des	P
compte_tenu_du	P
compter	VINF
comptes	NC
comptoir	NC
concentration	NC
concentre	V
concept	NC
conception	NC
concernant	P
concerne	V
concert	NC
concertation	NC
concession	NC
concessions	NC
concilier	VINF
conclu	VPP
concluent	V
conclure	VINF
conclusion	NC
conclut	V
concourant	VPR
concours	NC
concret	ADJ
concrets	ADJ
concurrence	NC
concurrent	NC
concurrents	NC
condamnation	NC
condamne	V
condamnent	V
condition	NC
conditions	NC
conduire	VINF
conduisaient	V
conduit	VPP
conduites	VPP
confiait	V
confiance	NC
confiant	VPR
confidentiel	ADJ
confirmation	NC
confirme	V
confirmer	VINF
conflit	NC
conflits	NC
conforme	ADJ
conformes	ADJ
conforte	V
confusion	NC
conjoint	NC
conjoints	NC
conjoncture	NC
conjugaison	NC
connais	V
connaissances	NC
connaissent	V
connivence	NC
connu	ADJ
connu	VPP
connue	VPP
connues	ADJ
connus	VPP
consacraient	V
conscience	NC
consciencieusement	ADV
conscient	ADJ
conseil	NPP
conseiller	NC
conseils	NC
consensuel	ADJ
consensus	NC
consentement	NC
consenties	VPP
conservateur	ADJ
conservateurs	ADJ
conserver	VINF
conserveront	V
consiste	V
consolidation	NC
consommateurs	NC
consommation	NC
consommer	VINF
consortium	NC
constamment	ADV
constance	NC
constat	NC
constater	VINF
constats	NC
consternation	NC
constituant	VPR
constitue	V
constituent	V
constituer	VINF
constitutif	ADJ
constitution	NC
constitutionnel	ADJ
constitutive	ADJ
constructeur	NC
constructeurs	NC
constructif	ADJ
construction	NC
construit	VPP
construits	VPP
consulter	VINF
contact	NC
contacts	NC
contagieuse	ADJ
contentant	VPR
contente	V
contenter	VINF
contentieux	NC
contenu	NC
contestable	ADJ
contestaient	V
contestation	NC
continents	NC
continuation	NC
continue	ADJ
continue	V
continuent	V
continuer	VINF
contourner	VINF
contractuel	ADJ
contractuelle	ADJ
contraignante	ADJ
contraignent	V
contraint	VPP
contraintes	NC
contraire	ADJ
contraire	NC
contrat	NC
contrats	NC
contre	ADV
contre	P
contrepartie	NC
contribue	V
contribuer	VINF
contribution	NC
convaincre	VINF
convention	NC
conventionnel	ADJ
conventionnelles	ADJ
conventionnels	ADJ
convergences	NC
conversion	NC
convertibles	ADJ
convocation	NC
coordination	NC
coordonner	VINF
copie	NC
coproduction	NC
coquilles	NC
corporatismes	NC
corporatiste	ADJ
corporatistes	ADJ
corps	NC
correctionnel	ADJ
correspondance	NC
correspondant	NC
correspondant	VPR
corruption	NC
costumes	NC
cotation	NC
cote	NC
coteries	NC
cotisation	NC
cotisations	NC
cotisent	V
coup	NC
coupe	NC
couperet	NC
coupes	NC
couple	NC
coups	NC
cour	NC
courage	NC
courageuse	ADJ
courageuses	ADJ
courant	ADJ
courant	VPR
courante	ADJ
courants	NC
courir	VINF
couronner	VINF
couronnes	NC
courrier	NC
cours	NC
court	ADJ
courtage	NC
courts	ADJ
couverture	NC
couvre	V
couvrent	V
couvrira	V
craignent	V
craint	VPP
crainte	NC
craintes	NC
crampes	NC
credit	ET
creuser	VINF
creuset	NC
crime	NC
cris	NC
crise	NC
critiquant	VPR
critique	V
critiquent	V
critiques	ADJ
critiques	NC
croire	VINF
croissance	NC
croissant	ADJ
croissante	ADJ
croissantes	ADJ
croissants	ADJ
croissent	V
croix	NC
croyaient	V
croyait	V
crucial	ADJ
cubiste	ADJ
cueille	V
cueillies	VPP
cuirs	NC
cuisant	ADJ
cuisine	NC
culture	NC
culturel	ADJ
culturelle	ADJ
culturelles	ADJ
curieux	ADJ
danger	NC
dangereuse	ADJ
dangereux	ADJ
danois	ADJ
danoise	ADJ
dans	P
dans_ce_sens	ADV
dans_la_limite_de	P
dans_le_cadre_du	P
dans_un_premier_temps	ADV
dans_une_large_mesure	ADV
date	NC
dates	NC
dauphin	NC
davantage	ADV
davantage_que	CS
de	DET
de	P
de_base	ADJ
de_dos	ADV
de_fait	ADV
de_la	DET
de_la_part_du	P
de_mise	ADV
de_moins_de	P
de_peur_de	P
de_plus	ADV
de_plus_en_plus	ADV
de_plus_que	P
de_services	ADV
de_taille	ADV
de_toutes_parts	ADV
debout	ADV
demandaient	V
demandant	VPR
demande	NC
demande	V
demander	VINF
demandes	NC
demeurant	VPR
demeure	V
demi	ADJ
demi	NC
demie	ADJ
demie	NC
dent	NC
dentaire	ADJ
depuis	ADV
depuis	P
depuis_peu	ADV
derechef	ADV
dernier	ADJ
dernier	NC
derniers	ADJ
des	DET
descendre	VINF
description	NC
desserts	NC
dessin	NC
dessins	NC
destin	NC
destinations	NC
dette	NC
deutschemark	NC
deutschemarks	NC
deux	ADJ
deux	DET
deux	NC
deux	PRO
deux_cents	DET
deux_mille	DET
devaient	V
devait	V
devant	P
devant	VPR
devants	NC
devenait	V
devenir	NC
devenir	VINF
devenu	VPP
devenue	VPP
deviendra	V
deviendrait	V
devient	V
devise	NC
devises	NC
devoir	VINF
devoirs	NC
devra	V
devraient	V
devrait	V
devront	V
diable	NC
dialectique	ADJ
dialogue	NC
dictature	NC
didactique	ADJ
difficile	ADJ
difficiles	ADJ
diffusion	NC
dimanche	NC
diminuer	VINF
diminueront	V
diminution	NC
dire	NC
dire	VINF
direct	ADJ
directement	ADV
directeur	ADJ
directeur	NC
directeurs	NC
direction	NC
directions	NC
directive	NC
directs	ADJ
dirige	V
dirigeants	NC
diront	V
disait	V
discipline	NC
disciplines	NC
discours	NC
discrets	ADJ
discussion	NC
discussions	NC
discuter	VINF
disparition	NC
disparu	VPP
disperser	VINF
disponible	ADJ
disponibles	ADJ
disposant	VPR
dispose	V
dispositif	NC
disposition	NC
dispositions	NC
disques	NC
dissiper	VINF
distances	NC
distinction	NC
distribueront	V
distributeurs	NC
distribution	NC
dit	V
dite	VPP
dites	ADJ
dites	VPP
diverses	ADJ
diverses	DET
division	NC
dix	ADJ
dix	DET
dizaine	NC
dizaines	NC
dockers	NC
docks	NC
doctrine	NC
document	NC
documentation	NC
documents	NC
dogme	NC
doigt	NC
doit	V
doivent	V
dollar	NC
dollars	NC
domaine	NC
domestique	ADJ
domestiques	ADJ
domine	V
dommages	NC
donatrice	ADJ
donc	ADV
donna	V
donne	V
donnent	V
donner	VINF
donnera	V
dont	PROREL
dormir	VINF
dossier	NC
dossiers	NC
dotations	NC
dote	V
douane	NC
douanes	NC
double	ADJ
double	NC
double	V
doublement	ADV
doubler	VINF
douloureux	ADJ
doute	NC
douze	ADJ
douze	DET
draconiens	ADJ
dragon	NC
dragons	NC
drame	NC
drogue	NC
droit	NC
droite	NC
droits	NC
du	DET
du_fait_de	P
dues	VPP
dur	ADJ
durable	ADJ
durables	ADJ
durant	P
dure	ADJ
dynamisme	NC
eau	NC
eaux	NC
effectif	NC
effectifs	NC
effectivement	ADV
effectives	ADJ
effet	NC
effets	NC
efficace	ADJ
efficacement	ADV
effondrement	NC
efforcent	V
effort	NC
efforts	NC
elle	CLS
elle	PRO
elles	CLS
elles	PRO
embauche	NC
embauchent	V
embauches	NC
embellie	NC
embrassant	VPR
embraye	V
emmenthal	NC
empire	NC
empiriquement	ADV
emploi	NC
emploie	V
emplois	NC
employeurs	NC
emporter	VINF
emprisonnement	NC
emprunt	NC
emprunte	V
emprunts	NC
en	CLO
en	P
en_accord_avec	P
en_apparence	ADV
en_aucun_cas	ADV
en_avant	ADV
en_baisse	ADV
en_baisse_de	P
en_cause	ADV
en_ce_qui_concerne	P
en_charge	ADV
en_commun	ADV
en_compte	ADV
en_connaissance_de_cause	ADV
en_cours	ADV
en_cours_de	P
en_effet	ADV
en_fait	ADV
en_faveur_de	P
en_faveur_des	P
en_fonction_de	P
en_fonction_des	P
en_fonction_du	P
en_grande_partie	ADV
en_guise_de	P
en_hausse	ADV
en_jeu	ADV
en_main	ADV
en_moyenne	ADV
en_nature	ADV
en_otage	ADV
en_outre	ADV
en_particulier	ADV
en_partie	ADV
en_passant_par	P
en_perspective	ADV
en_place	ADV
en_principe	ADV
en_quelque_sorte	ADV
en_raison_de	P
en_relation_avec	P
en_relief	ADV
en_revanche	ADV
en_somme	ADV
en_temps_et_en_heure	ADV
en_termes_de	P
en_tout_cas	ADV
en_train_de	P
en_valeur	ADV
en_vente	ADV
en_vigueur	ADV
en_voie_de	P
en_vrac	ADV
enclins	ADJ
encore	ADV
encourir	VINF
encre	NC
endettement	NC
endroits	NC
enfance	NC
enfant	NC
enfantine	ADJ
enfants	NC
enfer	NC
enfin	ADV
enfouis	V
engagements	NC
engagent	V
engager	VINF
enjeu	NC
enjoint	VPP
enrayer	VINF
enregistrait	V
enregistrer	VINF
enseignants	NC
ensemble	ADV
ensemble	NC
ensuite	ADV
entamer	VINF
entend	V
entendait	V
entendent	V
entendre	VINF
entendu	VPP
enthousiasme	NC
entier	ADJ
entourant	VPR
entre	P
entrefaites	NC
entregent	NC
entrepreneurs	NC
entreprise	NC
entreprises	NC
entrer	VINF
entretien	NC
entretiennent	V
entretiens	NC
envenimer	VINF
envergure	NC
enverra	V
envie	NC
environ	ADV
environnement	NC
envisage	V
envisageons	V
envisager	VINF
envisagerait	V
envoyant	VPR
erreur	NC
erreurs	NC
escadron	NC
esclavage	NC
escompte	NC
espagnols	ADJ
espoir	NC
espoirs	NC
esprit	NC
essayer	VINF
essentiellement	ADV
essor	NC
est	NPP
est	V
estimaient	V
estimait	V
estimant	VPR
estimation	NC
estimations	NC
estime	V
estiment	V
estimer	VINF
estimez	V
estomac	NC
estuaire	NC
et	CC
eu	V
eu	VPP
eu_lieu	VPP
eurosceptiques	NC
eux	PRO
ex	ET
exact	ADJ
exacte	ADJ
exactement	ADV
examen	NC
examiner	VINF
exception	NC
exceptionnel	ADJ
excessif	ADJ
exclus	VPP
exclusion	NC
exclusivement	ADV
excuser	VINF
exemplaire	ADJ
exemplaires	NC
exemple	NC
exempte	ADJ
exercer	VINF
exercice	NC
exercices	NC
exergue	NC
exigeant	ADJ
exigences	NC
exigent	V
exiger	VINF
exigerait	V
existant	ADJ
existants	ADJ
existe	V
existence	NC
existent	V
expansion	NC
expert	NC
expertise	NC
experts	NC
expiration	NC
explication	NC
explicitement	ADV
expliquant	VPR
explique	V
expliquent	V
expliquent	VS
expliquer	VINF
expliqueront	V
exploitants	NC
exploitation	NC
exploitations	NC
explosent	V
explosion	NC
expo	NC
exportable	ADJ
exportateur	NC
exportateurs	ADJ
exportateurs	NC
exportation	NC
exportations	NC
exposition	NC
expovente	NC
expression	NC
exprimant	VPR
exprimer	VINF
extension	NC
extraordinaire	ADJ
fabricants	NC
fabrication	NC
fabrique	V
face	NC
facilement	ADV
facilitent	V
faciliter	VINF
facteurs	NC
facture	NC
faible	ADJ
faibles	ADJ
faiblesse	NC
faillite	NC
faim	NC
faire	NC
faire	VINF
faire_appel	VINF
faire_pression	VINF
faire_preuve	VINF
faisait	V
faisant	VPR
fait	NC
fait	V
fait	VPP
fait_mine	V
fait_preuve	VPP
fait_suite	V
faite	VPP
faites	VPP
faits	NC
faits	VPP
fallait	V
falloir	VINF
fallu	VPP
fameuse	ADJ
familial	ADJ
familiale	ADJ
familiales	ADJ
familiaux	ADJ
familier	ADJ
famille	NC
familles	NC
fard	NC
fascisme	NC
fatidiques	ADJ
faudra	V
faudrait	V
fausser	VINF
faut	V
faute_de	P
favorable	ADJ
favorablement	ADV
favorables	ADJ
favorise	V
favorisent	V
favoriser	VINF
femme	NC
femmes	NC
fera	V
ferait	V
fermement	ADV
fermeture	NC
feront	V
feu	NC
feuilles	NC
feuilletons	VIMP
fiche	V
fictive	ADJ
figuraient	V
figurait	V
figurent	VS
files	NC
filiale	NC
filiales	NC
films	NC
fin	ADV
fin	NC
final	ADJ
finalement	ADV
finance	NC
financement	NC
financer	VINF
finances	NC
financier	ADJ
financiers	ADJ
financiers	NC
fini	ADJ
finir	VINF
finissent	V
finit	V
finlandais	ADJ
fins	NC
firme	NC
firmes	NC
fiscal	ADJ
fiscale	ADJ
fiscales	ADJ
fiscaux	ADJ
fixe	ADJ
fixer	VINF
flair	NC
flatte	V
flatteuse	ADJ
flexible	ADJ
florissante	ADJ
flot	NC
flotte	NC
flottement	NC
flou	NC
fluviales	ADJ
flux	NC
fois	NC
fonction	NC
fonctionnaire	NC
fonctionnaires	NC
fonctionne	V
fonctionnement	NC
fonctionnent	V
fonctions	NC
fond	NC
fondamental	ADJ
fondateurs	ADJ
fondent	V
fonderie	NC
fonds	NC
font	V
forces	NC
forgeron	NC
formant	VPR
formation	NC
formats	NC
forme	NC
formel	ADJ
former	VINF
formes	NC
formidable	ADJ
formule	NC
formuler	VINF
fort	ADJ
fort	ADV
forte	ADJ
fortement	ADV
fortes	ADJ
fortifient	V
forts	ADJ
forts	NC
forum	NC
foudres	NC
fougue	NC
fourchette	NC
fournier	NC
fournisse	VS
fournisseurs	NC
fournit	V
fragile	ADJ
frais	NC
franc	NC
franchir	VINF
franchissement	NC
francophobie	NC
francs	NC
fraudes	NC
frauduleuses	ADJ
freins	NC
fromage	NC
fromager	ADJ
frotte	V
fruit	NC
fumier	NC
fusils	NC
fusion	NC
fusions	NC
fut	V
futur	ADJ
futur	NC
gadget	NC
gage	NC
gagnaient	V
gagne	V
gain	NC
gains	NC
galaxie	NC
gamberge	V
gamins	NC
gamme	NC
garantie	ADJ
garantie	NC
garantir	VINF
garde	NC
gardent	V
garder	VINF
garderons	V
gardiens	NC
gars	NC
gauche	ADJ
gauche	NC
gel	NC
gendarme	NC
gendarmerie	NC
genre	NC
genres	NC
gens	NC
geste	NC
gestion	NC
gestionnaires	NC
ghettos	NC
gisements	NC
glaces	NC
glissade	NC
glissement	NC
global	ADJ
globale	ADJ
globales	ADJ
globalisation	NC
gonfler	VINF
gosse	NC
goutte	NC
gouvernement	NC
gouvernemental	ADJ
gouvernementale	ADJ
gouvernementales	ADJ
gouvernementaux	ADJ
gouvernements	NC
gouverneur	NC
grand	ADJ
grande	ADJ
grandes	ADJ
grandissante	ADJ
grandit	V
grands	ADJ
grands	NC
graphiques	NC
grave	ADJ
graves	ADJ
grenade	NC
grenouille	NC
grille	NC
grilles	NC
grimpait	V
grimperont	V
gros	ADJ
grosse	ADJ
groupe	NC
groupement	NC
groupements	NC
groupes	NC
guerre	NC
guichets	NC
gymnases	NC
gymnastique	NC
habilement	ADV
habitant	NC
habitent	V
habituel	ADJ
habituelle	ADJ
habituelles	ADJ
handicaps	NC
hardi	ADJ
hasard	NC
hausse	NC
hausses	NC
haute	ADJ
hautement	ADV
hauts	ADJ
hebdomadaire	ADJ
hebdomadaire	NC
hebdomadaires	NC
hectare	NC
herbagers	ADJ
heure	NC
heures	NC
heurte	V
heurtent	V
heurter	VINF
hexagone	NC
histoire	NC
historique	ADJ
historiques	ADJ
hiver	NC
holding	NC
holding_financier	NC
holdings	NC
homeless	ET
homme	NC
hommes	NC
homologation	NC
homologues	NC
hongrois	ADJ
honorer	VINF
horaire	ADJ
hormis	P
hors	ADV
hors_de	P
hospitaliers	ADJ
hospitalisation	NC
hostiles	ADJ
huit	ADJ
huit	DET
huit_cents	DET
humaines	ADJ
humeur	NC
hyperinflation	NC
hypocrisie	NC
ici	ADV
iconoclaste	ADJ
identique	ADJ
ignorance	NC
ignorant	VPR
ignore	V
ignorer	VINF
il	CLS
il_est_vrai	ADV
il_y_a	P
il_y_a	V
illustrations	NC
illustre	V
ils	CLS
image	NC
images	NC
imaginaire	NC
imagination	NC
immeubles	NC
immigration	NC
imminent	ADJ
immobilier	ADJ
immobilisme	NC
imparfait	ADJ
impitoyable	ADJ
implantation	NC
impliquant	VPR
implique	V
impopulaires	ADJ
importance	NC
important	ADJ
importante	ADJ
importantes	ADJ
importations	NC
importer	VINF
imposable	ADJ
impose	V
imposent	V
imposer	VINF
impossible	ADJ
impression	NC
improvisent	V
impuissance	NC
in_fine	ADV
inacceptables	ADJ
inactifs	NC
inapplicable	ADJ
inattaquable	ADJ
incapable	ADJ
incertaine	ADJ
incertains	ADJ
incessante	ADJ
incessants	ADJ
incidence	NC
incitation	NC
incitatives	ADJ
incite	V
inciter	VINF
incliner	VINF
incluant	VPR
incombent	V
inconnu	ADJ
incontestable	ADJ
indemnisation	NC
indicateurs	NC
indicative	ADJ
indice	NC
indigence	NC
indiquait	V
indique	V
indirecte	ADJ
indirectement	ADV
indiscutable	ADJ
indispensable	ADJ
indistinctes	ADJ
individuelle	ADJ
individuellement	ADV
individuelles	ADJ
individuels	ADJ
individus	NC
induits	VPP
indulgence	NC
industrie	NC
industriel	ADJ
industrielle	ADJ
industrielles	ADJ
industriels	ADJ
industriels	NC
industries	NC
industrieuse	ADJ
inenvisageables	ADJ
inexorablement	ADV
infini	ADJ
infiniment	ADV
inflation	NC
inflationniste	ADJ
inflexion	NC
influence	NC
influent	ADJ
influente	ADJ
informant	VPR
information	NC
informations	NC
informatique	ADJ
informatique	NC
infractions	NC
infructueuse	ADJ
infructueuses	ADJ
initial	ADJ
initiative	NC
initiatives	NC
injecte	V
injustement	ADV
innombrables	ADJ
inquiet	ADJ
inscrit	V
inscrit	VPP
inscrite	VPP
inscrits	ADJ
insertion	NC
insistaient	V
insoluble	ADJ
insolvable	ADJ
inspecteur	NC
inspection	NC
inspira	V
inspire	V
instance	NC
instant	NC
instauration	NC
institut	NC
instituteurs	NC
institutions	NC
instrument	NC
insuffisamment	ADV
insuffisance	NC
insuffisante	ADJ
intellectuelles	ADJ
intelligence	NC
intelligentes	ADJ
intensifiait	V
intensifier	VINF
intentions	NC
inter	ADJ
interactifs	ADJ
interlocuteurs	NC
international	ADJ
international	ET
international	NC
internationale	ADJ
internationales	ADJ
internationalisation	NC
internationaux	ADJ
interne	ADJ
internes	ADJ
interprofessionnel	ADJ
interrogations	NC
interrogeait	V
interrogent	V
interrompre	VINF
interrompu	VPP
intersyndicale	ADJ
intervalle	NC
intervenant	VPR
intervention	NC
interventionnisme	NC
interventionniste	ADJ
intervenu	VPP
intervenue	VPP
intervenues	VPP
interviendrait	V
interviennent	V
intervient	V
intoxication	NC
introduction	NC
introduire	VINF
introduit	VPP
introduite	VPP
inventaire	NC
inventer	VINF
inverse	NC
inverse	V
inverser	VINF
investi	VPP
investir	VINF
investissant	VPR
investissement	NC
investissements	NC
investisseurs	NC
invitant	VPR
irresponsable	ADJ
issu	VPP
issue	NC
issue	VPP
issus	VPP
italien	ADJ
italienne	ADJ
jacqueries	NC
jamais	ADV
jambes	NC
janvier	NC
japonais	ADJ
japonais	NC
japonaise	ADJ
japonaises	ADJ
jardinage	NC
je	CLS
jette	VS
jeu	ADJ
jeu	NC
jeudi	NC
jeune	ADJ
jeunes	ADJ
jeunes	NC
jeunesse	NC
jeux	NC
joindre	VINF
joint	VPP
joliment	ADV
joue	NC
jouer	VINF
jouet	NC
jour	NC
journal	NC
journalistes	NC
journaux	NC
jours	NC
judiciaire	ADJ
juge	NC
juge	V
jugeaient	V
jugeant	VPR
jugement	NC
juillet	NC
juin	NC
jumeaux	NC
juridique	ADJ
juridiques	ADJ
jurisprudence	NC
juste	ADJ
juste	ADV
justement	ADV
justice	NC
justifie	V
juxtaposition	NC
kids	NC
kilo	NC
la	CLO
la	DET
la_plupart_du	DET
la_veille	ADV
laborieusement	ADV
ladite	ADJ
laisser	VINF
laissez	V
lait	NC
laiterie	NC
laitiers	ADJ
lambris	NC
lancement	NC
lancer	VINF
lancinant	ADJ
langage	NC
langue	NC
laquelle	PROREL
large	ADJ
large	NC
largement	ADV
latitudes	NC
laxiste	ADJ
le	CLO
le	DET
le_plus	ADV
le_plus_possible	ADV
le_plus_souvent	ADV
leader	ADJ
leader	NC
lecteur	NC
lecteurs	NC
lecture	NC
lendemain	NC
lent	ADJ
lente	ADJ
lentement	ADV
lequel	PROREL
les	CLO
les	DET
lesdits	ADJ
lesquelles	PROREL
lesquels	PROREL
lesquels	PROWH
lessive	NC
lettre	NC
leur	CLO
leur	DET
leurs	DET
lever	VINF
libre	ADJ
libres	ADJ
licence	NC
licenciement	NC
licenciements	NC
licencient	V
licencier	VINF
liens	NC
lieu	NC
lieux	NC
ligaments	NC
ligne	NC
lignes	NC
limitant	VPR
limitations	NC
limite	NC
limiter	VINF
limites	NC
liquidation	NC
liquide	ADJ
liquide	V
liquider	VINF
lire	NC
lire	VINF
listes	NC
lit	NC
litres	NC
littorales	ADJ
livraison	NC
livre	NC
livrent	V
livrer	VINF
livres	NC
livrets	NC
lobbies	NC
lobby	NC
locales	ADJ
locatif	ADJ
locaux	ADJ
logement	NC
logements	NC
loger	VINF
logique	NC
logistique	NC
loi	NC
loin_de	P
lointain	ADJ
lois	NC
loisir	NC
long	ADJ
longtemps	ADV
longue	ADJ
longues	ADJ
lors_de	P
lors_des	P
lorsque	CS
louable	ADJ
lourd	ADJ
lourde	ADJ
lourds	ADJ
loyer	NC
loyers	NC
lucratifs	ADJ
lui	CLO
lui	PRO
lundi	NC
lutte	NC
lutter	VINF
luttes	NC
luxe	NC
luxembourgeois	ADJ
luxembourgeoise	ADJ
lyonnais	ADJ
lyonnaise	ADJ
lyonnaise	NC
machinal	ADJ
machine	NC
magasins	NC
magazine	NC
magazines	NC
magistrat	NC
mai	NC
maillage	NC
maillon	NC
main	NC
mainmise	NC
mains	NC
maintenance	NC
maintenant	ADV
maintenant	VPR
maintenir	VINF
maintenue	VPP
maintien	NC
maintient	V
maires	NC
mairie	NC
mais	ADV
mais	CC
maison	ADJ
maison	NC
maisons	NC
majeurs	ADJ
majoration	NC
majorisme	NC
majoritaire	ADJ
mal	ADJ
mal	ADV
mal	NC
malade	ADJ
malades	NC
maladie	NC
maladies	NC
malchance	NC
malheureusement	ADV
malins	ADJ
mandant	NC
mandants	NC
mandat	NC
mandataires	NC
mandats	NC
manifestant	NC
manifestants	NC
manifestation	NC
manifestations	NC
manifeste	NC
manifeste	V
manoeuvre	NC
manque	V
manquements	NC
marchand	ADJ
marchand	NC
marchande	ADJ
marchandises	NC
marchands	ADJ
marchands	NC
marche	NC
mardi	NC
marge	NC
marges	NC
marin	ADJ
marins	NC
maritime	ADJ
maritimes	ADJ
mark	NC
marks	NC
marque	NC
marque	V
marquer	VINF
marqueront	V
marques	NC
mars	NC
marseillaise	ADJ
masquer	VINF
masse	NC
massif	NC
massivement	ADV
maternelle	ADJ
matin	ADV
matin	NC
maturation	NC
mauvais	ADJ
mauvaises	ADJ
maximale	ADJ
maximiser	VINF
maximum	NC
me	CLO
meilleur	ADJ
meilleure	ADJ
meilleures	ADJ
meilleurs	ADJ
meilleurs	NC
membre	NC
membres	ADJ
menace	NC
mendiants	NC
mener	VINF
mensuel	ADJ
mensuelle	ADJ
mensuels	ADJ
menteur	NC
menton	NC
mer	NC
mercredi	NC
message	NC
mesure	NC
mesurent	V
mesures	NC
met	V
mettant	VPR
mettent	V
mettra	V
mettre	VINF
mettre_fin	VINF
meubler	VINF
mexicain	ADJ
micros	NC
midi	NC
mieux	ADV
milieux	NC
militaire	ADJ
militaires	ADJ
militant	NC
mille	DET
milliard	NC
milliards	NC
milliers	NC
million	NC
millions	NC
minime	ADJ
minimiser	VINF
minimum	ADJ
ministre	NC
ministres	NC
minoritaires	ADJ
miracle	ADJ
miracle	NC
mis	VPP
mise	NC
mise	VPP
mise_en_vente	NC
mises	NC
mission	NC
mistigri	NC
mixte	ADJ
mixtes	ADJ
moderniser	VINF
modes	NC
modestie	NC
modification	NC
modifier	VINF
moeurs	NC
moi	PRO
moindre	ADJ
moins	ADV
moins	NC
mois	NC
moment	NC
monde	NC
monde	NPP
mondial	ADJ
mondiale	ADJ
mondiales	ADJ
monnaie	NC
monopole	NC
montage	NC
montages	NC
montant	NC
montent	V
monter	VINF
montrant	VPR
montre	V
montrent	V
monuments	NC
moque	V
moquette	NC
moral	NC
moratoire	NC
mortel	ADJ
morts	NC
mot	NC
motion	NC
motor	NC
mots	NC
moule	NC
mouture	NC
mouvement	NC
mouvements	NC
moyen	ADJ
moyen	NC
moyenne	ADJ
moyens	NC
multinationale	NC
multiples	ADJ
multiplication	NC
multiplient	V
multiplier	VINF
municipal	ADJ
musique	NC
mutation	NC
mutisme	NC
mutuels	ADJ
mythe	NC
n	NC
national	ADJ
national	ET
nationale	ADJ
nationales	ADJ
nationalisations	NC
nationaux	ADJ
nature	NC
ne	ADV
ne_pas	ADV
ne_plus	ADV
net	ADJ
nette	ADJ
nettement	ADV
nettement_plus	ADV
neuf	ADJ
neutre	ADJ
neutres	ADJ
ni	ADV
ni	CC
nier	VINF
nippon	ADJ
nippons	ADJ
niveau	NC
niveaux	NC
noble	ADJ
noir	ADJ
nom	NC
nombre	NC
nombre_de	DET
nombre_de	P
nombreuses	ADJ
nombreux	ADJ
nomination	NC
nominations	NC
nommer	VINF
non	ADV
non	PREF
non_plus	ADV
non_seulement	ADV
nord	NC
norias	NC
normal	ADJ
normale	ADJ
normalement	ADV
normande	ADJ
normes	NC
nos	DET
notables	ADJ
notables	NC
notamment	ADV
note	NC
note	V
notent	V
notes	NC
notion	NC
notions	NC
notre	DET
nouer	VINF
nous	CLO
nous	CLS
nouveau	ADJ
nouveaux	ADJ
nouveaux	NC
nouvel	ADJ
nouvelle	ADJ
nouvelle	NC
nouvelles	ADJ
novembre	NC
nuisible	ADJ
nul	DET
nulle	ADJ
nulle_part	ADV
nunuche	ADJ
objectif	NC
objectifs	NC
objet	NC
obligataire	ADJ
obligation	NC
obligations	NC
obligeait	V
observateur	NC
observatoire	NC
observer	VINF
obstacle	NC
obtenir	VINF
obtenu	VPP
obtiendra	V
occasion	NC
occasions	NC
occidental	ADJ
occidentaux	ADJ
occlusion	NC
occupants	NC
occupe	V
occupent	V
occuper	VINF
octobre	NC
octroi	NC
oeil	NC
oeufs	NC
oeuvrant	VPR
oeuvre	NC
of	ET
offensive	NC
offerte	VPP
offertes	VPP
officiel	ADJ
officielle	ADJ
officiellement	ADV
offre	NC
offre	V
offres	NC
offrir	VINF
ombrage	NC
omission	NC
on	CLS
ont	V
onze	ADJ
onze	DET
opinion	NC
oppose	V
opposer	VINF
opposition	NC
optimiste	ADJ
optimistes	ADJ
optique	NC
orbite	NC
ordinateur	NC
ordinateurs	NC
ordre	NC
organe	NC
organisant	VPR
organisation	NC
organisations	NC
organise	V
organiser	VINF
organisera	V
organisme	NC
organismes	NC
orientale	ADJ
orientation	NC
orientations	NC
original	ADJ
origine	NC
origine	V
orthodoxes	ADJ
ou	CC
oublier	VINF
oui	ADV
ours	NC
outil	NC
outils	NC
outre	P
outre_mesure	ADV
ouvert	VPP
ouverture	NC
ouvrage	NC
ouvrages	NC
ouvre	V
ouvrier	ADJ
ouvrier	NC
ouvriers	NC
ouvrir	VINF
page	NC
pages	NC
paie	NC
paie	V
paiement	NC
paiements	NC
paix	NC
palais	NC
palette	NC
panel	NC
panique	NC
panorama	NC
papetier	ADJ
par	P
par_ailleurs	ADV
par_exemple	ADV
par_la_suite	ADV
par_rapport_au	P
par_rapport_aux	P
paradoxale	ADJ
paradoxalement	ADV
paradoxe	NC
paraissent	V
paralyser	VINF
parc	NC
parce_que	CS
parcellisation	NC
parcours	NC
pareil	ADJ
pareille	ADJ
parents	NC
parfaite	ADJ
parfaitement	ADV
parfois	ADV
parisien	ADJ
parisienne	ADJ
parisiens	ADJ
parlaient	V
parlant	VPR
parle	V
parlementaire	ADJ
parlementaires	ADJ
parlementaires	NC
parlent	V
parler	VINF
parmi	P
parole	NC
parquet	NC
parraine	V
part	NC
partage	NC
partager	VINF
partant	NC
partenaire	NC
partenaires	NC
parti	NC
partial	ADJ
participants	ADJ
participation	NC
participations	NC
particularisme	NC
particuliers	NC
partie	NC
partiel	ADJ
partiellement	ADV
partielles	ADJ
parties	NC
partir	VINF
partis	NC
partisans	NC
parts	NC
paru	VPP
parvenir	VINF
parviennent	V
pas	ADV
pas_encore	ADV
pas_moins	ADV
passage	NC
passagers	NC
passe	V
passent	V
passer	VINF
passera	V
passerait	V
passif	ADJ
passif	NC
patrimoine	NC
patron	NC
patronal	ADJ
patronales	ADJ
patronat	NC
patronaux	ADJ
patrons	NC
pauvres	ADJ
payer	VINF
payiez	V
pays	NC
paysage	NC
paysans	NC
peau	NC
peaux	NC
peluche	NC
penche	V
pencher	VINF
pencheront	V
pendant	P
pensaient	V
pensait	V
penser	VINF
pension	NC
pensions	NC
perception	NC
perd	V
perdre	VINF
perds	V
perdu	VPP
perdues	ADJ
performance	NC
performances	NC
performante	ADJ
performants	ADJ
perle	NC
permanente	ADJ
permet	V
permettant	VPR
permettra	V
permettre	VINF
permis	NC
permis	VPP
permis_de_conduire	NC
permis_de_construire	NC
permutations	NC
persistants	ADJ
personnages	NC
personne	NC
personne	PRO
personnel	NC
personnels	NC
personnes	NC
perspective	NC
perspectives	NC
perte	NC
pertes	NC
perverse	ADJ
perversions	NC
pervertissent	V
pesante	ADJ
pesanteurs	NC
peser	VINF
peseta	NC
petit	ADJ
petite	ADJ
petits	ADJ
peu	ADV
peur	NC
peut	V
peuvent	V
phares	NC
pharmacie	NC
phase	NC
physiques	ADJ
picorer	VINF
pige	V
pilier	NC
piller	VINF
pilotes	NC
pinceaux	NC
pire	NC
place	NC
place	V
placer	VINF
places	NC
plafond	NC
plaidant	VPR
plaide	V
plaint	V
plainte	NC
plaisir	NC
plan	NC
planification	NC
plans	NC
plaque	NC
plateau	NC
plein_de_risques	ADJ
pleinement	ADV
plier	VINF
plume	NC
plus	ADV
plus	P
plus_de	P
plus_ou_moins	ADV
plus_que	ADV
plusieurs	ADJ
plusieurs	DET
pneus	NC
po	NC
poids	NC
poignard	NC
point	NC
pointe	NC
pointent	V
points	NC
poker	NC
policier	ADJ
politique	ADJ
politique	NC
politiquement	ADV
politiques	ADJ
politiques	NC
polonais	ADJ
polonaise	ADJ
polytechnicien	NC
ponctuelles	ADJ
pondent	V
pool	NC
popiwek	NC
popularisation	NC
population	NC
port	NC
portait	V
portant	VPR
porte	V
porte	VS
porte_parole	NC
portefeuilles	NC
porter	VINF
portera	V
porteurs	ADJ
portrait	NC
ports	NC
posait	V
pose	V
poser	VINF
poserait	V
positif	ADJ
positifs	ADJ
position	NC
positionnement	NC
positions	NC
positive	ADJ
possession	NC
possible	ADJ
possible	NC
possibles	ADJ
poste	NC
postes	NC
postiers	NC
postulats	NC
potentiel	NC
potentiels	ADJ
potentiels	NC
poudre	NC
poupe	NC
pour	P
pour_le_moment	ADV
pour_le_reste	ADV
pour_que	CS
pourcentage	NC
pourfendre	VINF
pourparlers	NC
pourquoi	CS
pourra	V
pourraient	V
pourrait	V
pourront	V
poursuit	V
poursuite	NC
poursuivaient	V
poursuivi	VPP
poursuivie	VPP
poursuivons	V
poursuivraient	V
poursuivre	VINF
pourtant	ADV
pourvoir	VINF
pousse	V
pouvaient	V
pouvait	V
pouvoir	NC
pouvoir	VINF
pouvoirs	NC
prairie	NC
pratique	V
pratiquement	ADV
pratiquent	V
pratiques	ADJ
premier	ADJ
premiers	ADJ
prenaient	V
prenait	V
prenant	VPR
prend	V
prendra	V
prendre	VINF
prendre_le_relais	VINF
prenne	VS
prennent	V
prennent	VS
presque	ADV
pressante	ADJ
presse	NC
presseraient	V
pression	NC
pressions	NC
prestations	NC
prestigieuse	ADJ
preuve	NC
preuves	NC
prime	NC
primes	NC
principal	ADJ
principal	NC
principale	ADJ
principalement	ADV
principales	ADJ
principaux	ADJ
principe	NC
printemps	NC
prions	V
prioritaire	ADJ
pris	ADJ
pris	VPP
pris_fin	VPP
prise	NC
prise	VPP
prises	NC
privatisables	ADJ
privatisation	NC
privatisations	NC
prix	NC
probable	ADJ
probablement	ADV
processus	NC
prochain	ADJ
prochaine	ADJ
prochainement	ADV
prochaines	ADJ
prochains	ADJ
proche	ADJ
proches	ADJ
procurant	VPR
producteur	NC
producteurs	NC
productif	ADJ
production	NC
productions	NC
productrice	NC
produire	VINF
produit	NC
produite	VPP
produits	NC
profession	NC
professionnalisation	NC
professionnalisme	NC
professionnel	ADJ
professionnel	NC
professionnelles	ADJ
professionnels	ADJ
professionnels	NC
professions	NC
profil	NC
profit	NC
profiter	VINF
profits	NC
programmables	ADJ
programmation	NC
programme	NC
programmes	NC
progresse	V
progressent	V
progresser	VINF
progresseront	V
progression	NC
progressive	ADJ
projet	NC
projets	NC
prolongation	NC
promesses	NC
promet	V
promettant	VPR
promis	VPP
promoteur	NC
promoteurs	NC
promotion	NC
promouvoir	VINF
pronostiquait	V
propos	NC
propose	V
proposer	VINF
proposera	V
proposition	NC
propositions	NC
propre	ADJ
proprement	ADV
propres	ADJ
protagonistes	NC
protection	NC
protestataires	NC
protestent	V
protester	VINF
protocole	NC
prouve	V
prouver	VINF
provenance	NC
provenant	VPR
proviendra	V
proviendraient	V
province	NC
provisoire	ADJ
provisoirement	ADV
provisoires	ADJ
provocateur	ADJ
provoquait	V
provoque	V
provoquer	VINF
psychologiques	ADJ
psychologues	NC
pu	VPP
pub	NC
public	ADJ
public	NC
publication	NC
publics	ADJ
publier	VINF
publique	ADJ
publiques	ADJ
puis	ADV
puis	CC
puise	V
puisque	CS
puissance	NC
puissant	ADJ
puissants	ADJ
puisse	VS
puissent	VS
pure	ADJ
put	V
quadriller	VINF
quai	NC
qualification	NC
qualitatif	ADJ
quand	CS
quantitative	ADJ
quarantaine	NC
quarante	DET
quartier	NC
quartiers	NC
quasiment	ADV
quatorze	DET
quatre	ADJ
quatre	DET
quatre	PRO
quatre_cents	DET
quatre_mille	DET
que	ADV
que	CS
que	PROREL
que	PROWH
que_si	ADV
quelle	ADJWH
quelle	DETWH
quelque	ADJ
quelque	ADV
quelque	DET
quelques	DET
quels	DETWH
querelles	NC
question	NC
questions	NC
qui	PROREL
qui	PROWH
qui_plus_est	ADV
quinze	ADJ
quinze	DET
quitte	V
quitter	VINF
quo	ET
quoi	PROWH
quota	NC
quotas	NC
quotidien	ADJ
quotidien	NC
quotidienne	ADJ
quotidiens	NC
rabais	NC
rachat	NC
rachats	NC
rachetant	VPR
racontait	V
radio	NC
radoub	NC
raffermissant	VPR
raffolent	V
ragaillardi	VPP
raid	NC
rail	NC
raison	NC
raisonnables	ADJ
raisons	NC
ralentie	VPP
ralenties	VPP
ralentissement	NC
ramener	VINF
rang	NC
ranimer	VINF
rapide	ADJ
rapidement	ADV
rapides	ADJ
rappel	NC
rappeler	VINF
rappelle	V
rapport	NC
rapprochement	NC
rapprocher	VINF
rares	ADJ
rassemblait	V
rassembler	NC
rassure	V
rassurent	VS
rationaliser	VINF
ratisser	VINF
rattrapage	NC
ravages	NC
ravis	ADJ
rayonner	VINF
rebelles	NC
rebond	NC
rebut	NC
recette	NC
recettes	NC
recevaient	V
recevoir	VINF
recherche	NC
recherche	V
recherches	NC
reclasse	V
reclassement	NC
recommandait	V
reconduction	NC
reconductions	NC
reconduit	VPP
reconduits	VPP
reconnaissance	NC
reconnaissent	V
reconnu	VPP
reconstruction	NC
reconstruire	VINF
reconversions	NC
record	ADJ
records	NC
recours	NC
recruter	VINF
rectificative	ADJ
rectifie	V
recueillis	VPP
redescendre	VINF
rediffusion	NC
redonne	V
redonnent	V
redoutent	V
redresse	V
redressement	NC
redresser	VINF
refait	V
referme	V
refonte	NC
refus	NC
refusait	V
refusant	VPR
refuse	V
refusent	V
refuser	VINF
regain	NC
regardant	VPR
regardent	V
regarder	VINF
regarderont	V
regrettable	ADJ
regrette	V
regretter	VINF
regroupement	NC
rejet	NC
rejetant	VPR
rejette	V
rejoindre	VINF
relance	NC
relancent	V
relancer	VINF
relate	V
relation	NC
relations	NC
relative	ADJ
relativement	ADV
relaxer	VINF
relents	NC
relevant	VPR
remarquer	VINF
remboursables	ADJ
remboursement	NC
remboursements	NC
remettre	VINF
remirent	V
remontent	V
remonter	VINF
rempiler	VINF
remplace	V
remplacer	VINF
remplir	VINF
remplis	VPP
remplissage	NC
rencontre	NC
rencontrer	VINF
rencontres	NC
rend	V
rendant	VPR
rendement	NC
rendements	NC
rendent	V
rendraient	V
rendrait	V
rendre	VINF
rendu	VPP
rendue	VPP
rendues	ADJ
renforce	V
renforcer	VINF
renouant	VPR
renouveler	VINF
renouvellement	NC
renouvellements	NC
rentable	ADJ
rente	NC
rentrer	VINF
renvoient	V
repart	V
replier	VINF
repointent	V
repose	V
reposent	V
repousser	VINF
reprenant	VPR
reprend	V
reprendre	VINF
repreneur	NC
reprennent	V
repris	VPP
reprise	NC
reprise	VPP
reproche	NC
reproche	V
respect	NC
respectant	VPR
respectifs	ADJ
respectivement	ADV
responsable	ADJ
responsable	NC
responsables	NC
ressemblaient	V
ressort	NC
ressortir	VINF
ressources	NC
restaient	V
restant	VPR
reste	NC
reste	V
restent	V
rester	VINF
restera	V
resteront	V
restitutions	NC
restriction	NC
restructuration	NC
restructurations	NC
retard	NC
retardait	V
retenir	VINF
retenue	VPP
retenues	VPP
retire	V
retirer	VINF
retour	NC
retrait	NC
retraite	NC
retraites	NC
retrouve	V
retrouvent	V
retrouver	VINF
revalorisation	NC
revaloriser	VINF
revenait	V
revendication	NC
revendications	NC
revenir	VINF
revenu	NC
revenu	VPP
revenus	NC
revenus	VPP
revers	NC
reviendrons	V
revivre	VINF
revoir	VINF
revu	VPP
revue	NC
revues	NC
revus	VPP
ribambelle	NC
riches	ADJ
richesse	NC
rien	PRO
rigide	ADJ
rigueur	NC
rire	NC
risquait	V
risque	NC
risque	V
risquent	V
risquerait	V
risques	NC
rituel	NC
rival	NC
rivale	NC
rives	NC
robots	NC
rocardien	ADJ
rompu	VPP
ronds	ADJ
room	NC
roquefort	NC
rose	ADJ
rouble	NC
roubles	NC
round	NC
route	NC
routes	NC
routiers	ADJ
routiers	NC
ruche	NC
rude	ADJ
rumeur	NC
rumeurs	NC
rupture	NC
rurale	ADJ
ruraux	ADJ
russe	ADJ
russes	ADJ
rustique	ADJ
rythme	NC
sa	DET
sacrifices	NC
saga	NC
sages	ADJ
saine	ADJ
sais	V
saisi	VPP
saisit	V
saison	NC
sait	V
salaire	NC
salaires	NC
salariale	ADJ
salariales	ADJ
salue	V
saluer	VINF
samedi	NC
sanction	NC
sanctionner	VINF
sanglots	NC
sans	ADV
sans	P
sans_cesse	ADV
sans_doute	ADV
satisfaction	NC
satisfaisant	ADJ
satisfait	ADJ
sauf	P
saurait	V
saut	NC
sauter	VINF
sauvegarde	NC
sauvetage	NC
savait	V
savant	ADJ
savoir	NC
savoir	VINF
savoirs	NC
scandale	NC
scandales	NC
scandinave	ADJ
sciemment	ADV
science	NC
scientifique	ADJ
scier	VINF
scolaire	ADJ
score	NC
scrupuleux	ADJ
se	CLR
second	ADJ
seconde	ADJ
seconde	NC
secouer	VINF
secours	NC
secousses	NC
secteur	NC
secteurs	NC
section	NC
sein	NC
seize	DET
selon	P
semaine	NC
semaines	NC
semblables	ADJ
semble	V
semblent	V
sembler	VINF
semestre	NC
semestrielle	ADJ
sens	NC
sensible	ADJ
sensiblement	ADV
sent	V
sentent	V
sentiment	NC
sentiments	NC
sentir	VINF
sept	ADJ
sept	DET
septembre	NC
sera	V
seraient	V
serait	V
seront	V
sert	V
servant	VPR
servent	V
service	NC
services	NC
servir	VINF
servira	V
ses	DET
session	NC
seuil	NC
seul	ADJ
seule	ADJ
seulement	ADV
seules	ADJ
sexes	NC
sextant	NC
show	NC
si	ADV
si	CS
si_possible	ADV
signale	V
signant	VPR
signataires	NC
signatures	NC
signe	NC
signer	VINF
signes	NC
signifiant	VPR
significative	ADJ
signifie	V
signifierait	V
simple	ADJ
simplement	ADV
simplificateurs	ADJ
simplification	NC
simplifier	VINF
sine_die	ADV
site	NC
situant	VPR
situation	NC
situations	NC
situe	V
situer	VINF
six	ADJ
six	PRO
ski	NC
social	ADJ
sociale	ADJ
sociales	ADJ
socialisation	NC
socialisme	NC
socialiste	ADJ
socialistes	ADJ
socialistes	NC
sociaux	ADJ
sociologue	NC
sociologues	NC
soi	PRO
soient	VS
soigner	VINF
soir	ADV
soir	NC
soit	ADV
soit	CC
soit	P
soit	VS
solde	NC
soldes	NC
solidaire	ADJ
solidaires	ADJ
solides	ADJ
sollicitations	NC
solution	NC
sombre	ADJ
sombrer	VINF
somme	NC
sommeil	NC
sommes	NC
sommes	V
sommet	NC
son	DET
sondage	NC
sondages	NC
songerait	V
sont	V
sort	NC
sort	V
sorti	VPP
souci	NC
soucieuses	ADJ
soucieux	ADJ
soudaine	ADJ
souffler	VINF
souffre	V
souhaitable	ADJ
souhaitait	V
souhaite	V
souhaitent	V
souligne	V
soulignent	V
souligner	VINF
soumettre	VINF
soumettront	V
soumis	VPP
soumission	NC
souple	ADJ
source	NC
sourds	ADJ
sourds	NC
sournois	ADJ
sous	P
sous_forme_de	P
sous_la_direction_de	P
souscrit	VPP
soutenir	VINF
soutenu	ADJ
soutenue	ADJ
soutien	NC
souvenirs	NC
souvent	ADV
spectacle	NC
spectaculaire	ADJ
spectaculaires	ADJ
sportives	ADJ
stabilisation	NC
stable	ADJ
stables	ADJ
stade	NC
stage	NC
stagnante	ADJ
standards	NC
state	ET
stations	NC
statistique	ADJ
statistique	NC
statistiquement	ADV
statistiques	NC
statu	ET
statuait	V
statut	NC
statutaires	ADJ
sterling	ET
stimuler	VINF
stock	NC
stocker	VINF
stocks	NC
stresser	VINF
strict	ADJ
structure	NC
structurer	VINF
studios	NC
su	VPP
subir	VINF
subira	V
subitement	ADV
subodorent	V
subsiste	V
subtil	ADJ
subvention	NC
subventions	NC
successeur	NC
successifs	ADJ
succession	NC
successivement	ADV
successives	ADJ
suffi	VPP
suffisamment	ADV
suffisant	ADJ
suffisante	ADJ
suffisent	V
suffit	V
suffrages	NC
suicides	NC
suisse	ADJ
suit	V
suite	NC
suivant	ADJ
suivant	P
suivants	ADJ
suivi	VPP
suivie	VPP
suivirent	V
suivre	VINF
super	ADJ
supervisent	V
superviser	VINF
supporte	V
supposera	V
supposerait	V
suppression	NC
supprimant	VPR
supprime	V
supprimer	VINF
supprimerait	V
sur	P
sur_fond_de	P
sur_la_voie_de	P
sur_le_terrain	ADV
sureffectifs	NC
surface	NC
surgir	VINF
surgissent	V
surmonter	VINF
surpris	VPP
surprise	NC
surqualification	NC
sursis	NC
surtout	ADV
surveillance	NC
survie	NC
survient	V
survivre	VINF
susceptible	ADJ
suspendre	VINF
suspendu	VPP
suspendue	VPP
suspense	NC
suspension	NC
sympas	ADJ
sympathies	NC
syndical	ADJ
syndicales	ADJ
syndicalisation	NC
syndicalisme	NC
syndicat	NC
syndicats	NC
synonyme	ADJ
tabac	NC
tabagisme	NC
table	NC
table	V
tableaux	NC
taille	NC
talonnant	VPR
tandis_que	CS
tankers	NC
tant	ADV
taquiner	VINF
tard	ADV
tardives	ADJ
tarifaire	ADJ
tarifs	NC
tassement	NC
taux	NC
taxation	NC
taxe	NC
taxi	NC
technicien	NC
technique	ADJ
technique	NC
techniques	ADJ
techniques	NC
technocrates	NC
technologie	NC
technologique	ADJ
tel	ADJ
telle	ADJ
telle	DET
telles	ADJ
tels	ADJ
temple	NC
temporairement	ADV
temps	NC
tenait	V
tenant	VPR
tendance	NC
tendances	NC
tendue	ADJ
tendus	ADJ
tension	NC
tensions	NC
tentaculaires	ADJ
tentative	NC
tentatives	NC
tente	V
tentent	VS
tenter	VINF
tenu	VPP
tenue	VPP
tenues	VPP
terme	NC
termes	NC
terminal	NC
terrain	NC
terre	NC
terrestres	ADJ
territoire	NC
teste	V
tests	NC
texte	NC
textes	NC
textile	ADJ
textile	NC
thromboses	NC
tiendront	V
tienne	VS
tiennent	VS
tiens	I
tient	V
tiers	NC
timide	ADJ
tire	V
tirent	V
tirer	VINF
tireront	V
titre	NC
titres	NC
titulaires	ADJ
titulaires	NC
toiles	NC
tombent	V
ton	DET
torpeur	NC
tort	NC
torture	NC
total	ADJ
total	NC
totale	ADJ
totalement	ADV
touchant	VPR
touche	V
touchent	V
toucher	VINF
touchera	V
toujours	ADV
toujours_pas	ADV
tour	NC
tourisme	NC
touristes	NC
touristique	ADJ
touristiques	ADJ
tournant	NC
tournante	ADJ
tourner	VINF
tous	ADJ
tous	DET
tous	PRO
tout	ADJ
tout	ADV
tout	DET
tout	NC
tout	PRO
tout_au_moins	ADV
tout_court	ADV
tout_juste	ADV
toute	ADJ
toute	DET
toutefois	ADV
toutes	ADJ
toutes	PRO
traces	NC
tractations	NC
tracteurs	NC
trade_unions	ET
traditionnel	ADJ
traditionnelles	ADJ
traditionnels	ADJ
traduction	NC
traduit	V
traduit	VPP
trafic	NC
trafics	NC
train	NC
trait	NC
traitement	NC
traiter	VINF
traites	NC
traits	NC
trajet	NC
tranche	NC
trancher	VINF
tranches	NC
transaction	NC
transactions	NC
transalpine	ADJ
transatlantique	ADJ
transfert	NC
transforment	V
transition	NC
transmis	VPP
transparence	NC
transport	NC
transporte	V
transporter	VINF
transporteurs	NC
transports	NC
travail	NC
travaille	V
travailler	VINF
travailleurs	NC
travaux	NC
treize	DET
trentaine	NC
trente	DET
trente_et_un	DET
tri	NC
tribunal	NC
tribut	NC
triche	V
trimestre	NC
trimestres	NC
trimestrielle	ADJ
trimestriels	ADJ
triomphalement	ADV
triomphe	NC
tripalium	ET
tripartite	ADJ
triple	ADJ
triste	ADJ
trois	ADJ
trois	DET
trois	PRO
trompeuses	ADJ
trop	ADV
troubles	NC
troupeau	NC
troupeaux	NC
troupes	NC
trouve	V
trouvent	V
trouver	VINF
trouvera	V
type	NC
ultrafrais	ADJ
un	DET
un	NC
un	PRO
un_moment	ADV
un_peu	ADV
un_peu_de	DET
un_peu_plus	ADV
une	ADJ
une	DET
une	NC
une	PRO
une_fois	ADV
une_fois_de_plus	ADV
une_fois_encore	ADV
unification	NC
union	NC
union	NPP
unique	ADJ
uniquement	ADV
univers	NC
universitaire	ADJ
univoque	ADJ
urbaines	ADJ
urbains	ADJ
urgence	NC
urgente	ADJ
urgents	ADJ
usent	V
user	VINF
usine	NC
usines	NC
usure	NC
utile	ADJ
utiles	ADJ
utilisant	VPR
utilisation	NC
utilisent	V
va	V
vacances	NC
vacanciers	NC
vacante	ADJ
vacants	ADJ
vache	NC
vaches	NC
vague	NC
vagues	NC
vaine	ADJ
valeur	NC
valeurs	NC
valse	NC
variables	ADJ
variations	NC
vaste	ADJ
vastes	ADJ
vaudra	V
veiller	VINF
veillerait	V
vend	V
vendent	V
vendeurs	NC
vendre	VINF
vendredi	NC
vendu	VPP
vendues	VPP
vendus	VPP
venir	VINF
vent	NC
vente	NC
ventes	NC
venu	VPP
venue	NC
venus	VPP
verbale	ADJ
verront	V
verrouiller	VINF
vers	P
versement	NC
versements	NC
verser	VINF
vertigineuses	ADJ
vertigineux	ADJ
vestige	NC
veulent	V
veut	V
via	P
viande	NC
victime	ADJ
victime	NC
victoire	NC
vides	NC
vie	NC
vieille	ADJ
vieillesse	NC
viennent	V
vient	V
vieux	ADJ
vif	ADJ
vigilance	NC
vigoureuse	ADJ
vigueur	NC
villes	NC
vingt	ADJ
vingt	DET
vingt_mille	ADJ
vingtaine	NC
violemment	ADV
violence	NC
virage	NC
virulentes	ADJ
visa	NC
visage	NC
visages	NC
vise	V
visent	V
visera	V
visiblement	ADV
vision	NC
visite	NC
visiteurs	NC
vite	ADV
vite_et_bien	ADV
vitesse	NC
vitrine	NC
vive	ADJ
vivement	ADV
vives	ADJ
vivre	VINF
vocation	NC
voeux	NC
voici	P
voie	NC
voient	V
voies	NC
voir	VINF
voire	CC
voisin	NC
voit	V
voitures	NC
vole	V
volent	V
voler	VINF
volet	NC
volontaire	ADJ
volontariat	NC
volontaristes	ADJ
vols	NC
voltigeurs	NC
volume	NC
volumes	NC
vont	V
vote	NC
votent	V
voter	VINF
votes	NC
votos	ET
votre	DET
voulaient	V
voulait	V
voulant	VPR
voulez	V
vouloir	NC
vouloir	VINF
voulons	V
voulu	VPP
vous	CLS
vous	PRO
voyage	NC
voyages	NC
vrai	ADJ
vraie	ADJ
vraies	ADJ
vraiment	ADV
vraisemblablement	ADV
vraisemblance	NC
vu	VPP
vue	NC
vues	VPP
vus	VPP
welfare	ET
world	ET
y	CLO
y_compris	ADV
yaourts	NC
yen	NC
yeux	NC
zappent	V
zapper	VINF
zapperaient	V
zapperont	V
zappeurs	NC
zapping	NC
zloty	NC
zlotys	NC
zone	NC
zones	NC
