!	PONCT
"	PONCT
%	NC
's	ET
+	P
,	PONCT
-	P
-	PONCT
-1991	NC
-8	ADJ
-LRB-	PONCT
-LRB-...-RRB-	PONCT
-RRB-	PONCT
-ce	CLS
-il	CLS
-ils	CLS
-les	CLO
-on	CLS
-t-elle	CLS
-t-il	CLS
-t-on	CLS
-vous	CLS
.	PONCT
...	PONCT
0,1	DET
0,3	DET
0,4	DET
0,5	DET
0,6	DET
0,7	DET
0,9	DET
1	ADJ
1	DET
1	NC
1,1	DET
1,2	DET
1,3	DET
1,5	ADJ
1,5	DET
1,50	DET
1,57	DET
1,58	DET
1,60	DET
1,62	DET
1,7	DET
1,74	DET
1,8	DET
1,90	DET
10	ADJ
10	DET
10,2	DET
10,5	DET
10,7	DET
100	DET
100	PRO
1000	DET
100000	DET
107	PRO
11	ADJ
11	DET
11,7	DET
110	DET
110	PRO
11000	PRO
118	DET
12	ADJ
12	DET
12,2	DET
120	DET
120000	DET
12150	DET
1235	DET
125	DET
12500	DET
12h30	NC
13	ADJ
13	DET
13,3	DET
13,8	ADJ
13,8	DET
130000	ADJ
130000	DET
14	ADJ
14	DET
14,2	DET
14,3	DET
140	DET
142	DET
143	DET
1441	DET
147,06	DET
15	ADJ
15	DET
150	DET
1500	DET
150000	DET
15h30	NC
16	ADJ
16	DET
16,2	DET
160	DET
169	DET
16h40	NC
16h50	NC
17	ADJ
17	DET
17000	ADJ
172	DET
176	DET
1789	NC
17h30	NC
17h40	NC
18	DET
188	DET
19	DET
190	DET
192	DET
1950	NC
1956	NC
1958	NC
1961	NC
1962	NC
1964	NC
1967	NC
1968	NC
1970	NC
1974,55	DET
1975	NC
1976	NC
1978	NC
1979	NC
1980	NC
1981	NC
1982	NC
1983	NC
1984	NC
1985	NC
1986	NC
1987	NC
1988	NC
1989	NC
1990	NC
1991	NC
1992	NC
1993	NC
1994	NC
1995	NC
1996	NC
199920	DET
19h55	NC
2	ADJ
2	DET
2,1	DET
2,2	DET
2,3	DET
2,4	DET
2,5	DET
2,8	DET
2,9	DET
20	ADJ
20	DET
200	DET
2000	NC
20000	DET
200000	PRO
2028	DET
21	ADJ
210	DET
213	DET
22	ADJ
220000	PRO
2224,11	DET
2251	DET
23	ADJ
24	ADJ
24	DET
25	ADJ
25	DET
250	DET
25000	DET
26	ADJ
26	DET
27	ADJ
271	DET
2720000	DET
275	DET
28	ADJ
28	DET
28,7	DET
2806	DET
3	ADJ
3	DET
3	NC
3,1	DET
3,2	DET
3,3	DET
3,4	DET
3,41	DET
3,42	DET
3,5	DET
3,56	DET
3,6	DET
3,65	DET
3,7	DET
3,73	DET
3,9	DET
30	ADJ
30	DET
30000	DET
30000	PRO
300000	PRO
305	DET
3090	DET
31	ADJ
310	DET
31000	DET
32	DET
3200	PRO
33,7	DET
3336,16	DET
34	DET
34,06	DET
34,07	DET
35	DET
350	DET
35000	DET
38	DET
390	DET
3900	DET
4	ADJ
4	DET
4,1	DET
4,2	DET
4,3	DET
4,35	DET
4,4	DET
4,45	DET
4,5	DET
4,6	DET
4,7	DET
4,8	DET
4,9	DET
40	ADJ
40	DET
400	DET
4000	DET
40000	DET
400000	DET
41	DET
41,19	DET
42,3	DET
43	ADJ
43	DET
441000	DET
446	DET
45	DET
47	DET
48	DET
49	DET
49,3	DET
49,32	DET
49,44	DET
4h30	NC
5	ADJ
5	DET
5	NPP
5,1	DET
5,14	DET
5,34	DET
5,39	DET
5,4	DET
5,45	DET
5,5	DET
5,52	DET
5,7	DET
5,75	DET
5,8	DET
5,9	DET
50	DET
50,6	DET
500	ADJ
500	DET
50000	DET
50000	PRO
500000	PRO
503	ADJ
506	ADJ
509	DET
51	DET
52	DET
52,3	DET
54	DET
54,5	DET
5500	DET
550000	DET
5543,30	DET
56	DET
57	DET
57000	ADJ
5756,14	DET
5759	ADJ
588	DET
59	DET
5h30	NC
6	ADJ
6	DET
6	NPP
6,3	DET
6,40	DET
6,6	DET
6,7	DET
6,70	DET
6,9	DET
60	ADJ
60	DET
60,1	PRO
60000	DET
61,7	DET
62	DET
620	DET
62000	DET
632	DET
65	DET
66	DET
66,7	DET
66,72	DET
68	DET
69	DET
69,5	DET
696	DET
6h20	NC
6h30	NC
7	ADJ
7	DET
7,09	DET
7,2	DET
7,4	DET
70	DET
700	ADJ
700	DET
7000	DET
70000	DET
700000	ADJ
700000	DET
71	DET
7400	ADJ
75	DET
75000	DET
77,4	DET
7719	ADJ
7720	ADJ
775	DET
7h20	NC
8	ADJ
8	DET
8	PRO
80	ADJ
80	DET
800	DET
80000	DET
847	DET
85	DET
9	ADJ
9	DET
9,5	DET
9,6	DET
9,94	DET
90	ADJ
90	DET
900000	PRO
91	NC
915000	PRO
92	ADJ
92	NC
9500	DET
970	ADJ
:	PONCT
;	PONCT
?	PONCT
A	NC
A	P
ACOSS	NPP
AGF	NPP
AGRR	NPP
ALAIN	NPP
ALLEMAGNE	NPP
AMX_-_30	NPP
ANPE	NC
APEC	NPP
ATR	NPP
AUTOMATISATION	NC
AVIA	NPP
A_-_26	NC
A_-_6	NC
A_contrario	ADV
A_partir_de_là	ADV
A_peine	ADV
A_telle_enseigne_que	CS
Abel	NPP
Abondamment	ADV
Abou	NPP
Acteur	NC
Actuellement	ADV
Adam	NPP
Agence	NC
Agents	NC
Agnelli	NPP
Agnès	NPP
Agricole	ADJ
Ain	NPP
Ainsi	ADV
Ainsi_que	CS
Air	NC
Airbus	NC
Airbus	NPP
Airlines	ET
Airways	ET
Alain	NPP
Albert	NPP
Alduy	NPP
Algérie	NPP
All	ET
Allemagne	NPP
Allemands	NC
Alors_même_que	CS
Alors_que	CS
Alsace	NPP
Amadeus	NPP
Américains	NC
Amériques	NPP
Anciennement	ADV
Anciens	NPP
Andersen	NPP
Anglais	NC
Angleterre	NPP
Anne	NPP
Anne_-_Marie	NPP
Antenne	NC
Antenne_2_-_FR_3	NPP
Antoine	NPP
Après	P
Argentine	NPP
Arkadi	NPP
Arlésienne	NC
Arnaud	NPP
Arthur	NPP
Assemblée	NC
Atlantique	NPP
Attali	NPP
Au_-_delà_de	P
Au_contraire	ADV
Au_cours_de	P
Au_cours_des	P
Au_demeurant	ADV
Au_mieux	ADV
Au_total	ADV
Aube	NPP
Aubert	NPP
Aubry	NPP
Auch	NPP
Aucun	PRO
Aucune	DET
Auguste	NPP
Aujourd'_hui	ADV
Auparavant	ADV
Aussi	ADV
Austrian	ET
Automatisation	NC
Autre	ADJ
Autrement_dit	ADV
Avant	P
Avec	P
Aveyron	NPP
Avez	V
Avia	NPP
Avignon	NPP
Ayant	VPR
Aérospatiale	NPP
B	NC
BCCI	NPP
BERD	NPP
BNCI	NPP
BNP	NPP
BP	NPP
BRUXELLES	NPP
BSN	NPP
BUE	NPP
Balcerowicz	NPP
Balfour	NPP
Balfour_Beatty_Projects_and_engineering_Ltd	NPP
Baltica	NPP
Bank	ET
Banque	NC
Banque_européenne_pour_la_reconstruction_et_le_développement	NPP
Barberis	NPP
Barking_-_Reach	NPP
Barre	NPP
Barrère	NPP
Baylet	NPP
Beatty	NPP
Belges	NPP
Belgique	NPP
Bercy	NPP
Bergougnoux	NPP
Bergé	NPP
Berlusconi	NPP
Bernard	NPP
Besnier	NPP
Bettino	NPP
Bianco	NPP
Bien_que	CS
Bilan	NC
Bisounours	NPP
Blanc	NPP
Blanche	ADJ
Bloch_-_lainé	NPP
Board	ET
Bon	ADJ
Bongrain	NPP
Bonn	NPP
Bordeaux	NPP
Bordelaise	NPP
Boris	NPP
Born	NPP
Boulevard	NC
Bourges	NPP
Bourse	NC
Bourses	NC
Bouter	VINF
Boutet	NPP
Boyer	NPP
Brantôme	NC
Bref	ADV
Brent	NPP
Brest	NPP
Bretagne	NPP
Bridel	NPP
Britanniques	NC
British	ET
British	NPP
Brothers	NPP
Bruxelles	NPP
Buchanan	NPP
Budapest	NPP
Bull	NPP
Bush	NPP
Bâle	NPP
Bérégovoy	NPP
C'	CLS
CBI	NPP
CBV	NPP
CED	NPP
CEE	NPP
CERC	NPP
CFAO	NPP
CFDT	NPP
CFE	NPP
CGC	NPP
CGT	NPP
CIC	NPP
CIRI	NPP
CLT	NPP
CNJA	NPP
CNRS	NC
COB	NPP
CSA	NC
CSA	NPP
CSF	NPP
CSG	NPP
CSMF	NPP
Cahin_-_caha	ADV
Caisse	NC
Caisse_des_dépôts_et_consignations	NC
Caisse_des_dépôts_et_consignations	NPP
Caisses	NC
Calais	NPP
Calédonie	NPP
Cambridge	ET
Canaille	NC
Canal	NPP
Canal_Plus	NPP
Capitalistique	ADJ
Caprice	NPP
Car	CC
Carrière	NC
Castelsarrasin	NPP
Cavaillon	NPP
Ce	CLS
Ce	DET
Ce	PRO
Cela	PRO
Celle_-_ci	PRO
Centre	NPP
Cependant	ADV
Certainement_pas	ADV
Certains	PRO
Certes	ADV
Ces	DET
Cet	DET
Cette	DET
Ceux_-_ci	PRO
Chaix	NPP
Chalvon	NPP
Chamard	NPP
Changez	V
Charles	NPP
Chirac	NPP
Cholet	NPP
Christian	NPP
Chrysler	NPP
Châlons_-_sur_-_Marne	NPP
Château	NPP
Cinq	NPP
Cinq	PRO
City	ET
Claude	NPP
Clermont_-_Ferrand	NPP
Club_mini_zig_-_Zag	NPP
Coeur	NC
Colombes	NPP
Comme	CS
Comme	P
Comme_s'	CS
Comme_si	CS
Comment	ADVWH
Commentant	VPR
Commission	NC
Communauté	NPP
Communautés	NC
Communication	NC
Compagnie	NC
Compte_tenu_des	P
Concrètement	ADV
Confederation_of_British_Industry	ET
Confirmant	VPR
Conformément	ADV
Confronté	VPP
Confédération	NC
Conférence	NC
Congrès	NC
Conjoncture	NC
Conjuguée	VPP
Conseil	NC
Conseil	NPP
Conseiller	NC
Consommation	NC
Constitution	NC
Consumer	NPP
Contrairement_à	P
Corset	NPP
Corée	NPP
Cosby	NPP
Cosson	NPP
Cottave	NPP
Council	ET
Cour	NC
Cousteau	NC
Craxi	NPP
Cresson	NPP
Croix	NPP
Créant	VPR
Crédit	NC
D'	DET
D'	DETWH
D'	P
D'_abord	ADV
D'_ailleurs	ADV
D'_autant	ADV
D'_autant_que	CS
D'_autre_part	ADV
D'_ores_et_déjà	ADV
D'_où	P
D'_une_part	ADV
DIVISION	NC
DM	NC
DOM	NPP
DRH	NC
Daimler_-_Benz	NPP
Daniel	NPP
Dans	P
Dans_ces_conditions	ADV
Dans_l'_attente_de	P
Dans_le_cadre_d'	P
Dans_le_cadre_de	P
Dans_le_cas_des	P
Dans_un_premier_temps	ADV
Dassault	NPP
Dauzier	NPP
David	NPP
De	P
De_La_Chauvinière	NPP
De_la_sorte	ADV
De_même	ADV
De_plus	ADV
De_semaine_en_semaine	ADV
Decampse	NPP
Delaporte	NPP
Demain	ADV
Denis	NPP
Denvers	NPP
Depuis	P
Dernier	ADJ
Dernière	ADJ
Des	DET
Destiné	VPP
Deutsche	ET
Deutsche	NPP
Deux	DET
Deuxième	ADJ
Deuxièmement	ADV
Devant	P
Development	ET
Deverloy	NPP
Deverra	NPP
Dhabi	NPP
Dieux	NC
Difficile	ADJ
Digne	NPP
Dijon	NPP
Discipline	NC
Dix	DET
Dnes	NPP
Docks	NC
Dominique	NPP
Dommage	ADV
Dommage	NC
Donald	NPP
Donnant	VPR
Dordogne	NPP
Dorothée	NPP
Douze	DET
Douze	NC
Dreyfus	NPP
Drian	NPP
Du_Tertre	NPP
Dumas	NPP
Dumon	NPP
Dunkel	NPP
Dupont	NPP
Duramé	NPP
Dès	P
Débutait	V
Déclaration	NC
Décret	NC
Défense	NC
Déjà	ADV
Désormais	ADV
Dévaluation	NC
EDF	NPP
ENA	NPP
ET	CC
Eaux	NC
Echiquier	NPP
Economic	ET
Economie	NC
Edith	NPP
Effectuée	VPP
Efforts	NC
Egor	NPP
Electronics	NPP
Elf_-_Aquitaine	NPP
Elle	CLS
Elle_et_Vire	NPP
Elles	CLS
Eltsine	NPP
En	P
En_attendant	ADV
En_cas_de	P
En_ce_qui_concerne	P
En_dépit_de	P
En_dépit_des	P
En_effet	ADV
En_fonction_de	P
En_hausse	ADV
En_moyenne	ADV
En_outre	ADV
En_revanche	ADV
En_vérité	ADV
Encore	ADV
Energy	ET
Enfin	ADV
Ensemble	ADV
Ensuite	ADV
Entre	P
Entremont	NPP
Eric	NPP
Erreur	NC
Escande	NPP
Espagne	NPP
Est	NC
Est	NPP
Est	V
Et	CC
Et_puis	CC
Etat	NC
Etat	NPP
Etat_-_providence	NC
Etats	NC
Etats_-_Unis	NPP
Eurojob	NPP
Europe	NPP
European	ET
Européens	NC
Evidemment	ADV
Exemple	NC
Exor	NPP
Eysymontt	NPP
F	NC
F.	NC
FAMILIALE	ADJ
FEHAP	NPP
FIEHP	NPP
FLEXIBLE	ADJ
FMI	NPP
FNSEA	NPP
FO	NPP
FR	NC
FR3	NPP
Fabius	NPP
Familles	NC
Farnoux	NPP
Fauroux	NPP
Fausse	ADJ
Faute_de	P
Fiat	NPP
Fin	NC
Fininvest	NPP
Fitzpatrick	NPP
Fixée	VPP
Floch	NPP
Fondation	NC
Force	NPP
Ford	NPP
Fourtou	NPP
France	NPP
Francfort	NPP
Francis	NPP
Franz	NPP
Français	NC
François	NPP
François_-_Xavier	NPP
Franès	NPP
Frederick	NPP
Fronta	NPP
Fédération	NPP
Fédérer	VINF
GAN	NPP
GATT	NPP
GEC_-_Alsthom	NPP
GIAT	NPP
GIE	NPP
GUF	NPP
Gaboriau	NPP
Gandois	NPP
Gaudillère	NPP
Gaz	NC
Gaïdar	NPP
General	NPP
Geneval	NPP
George	NPP
Georges	NPP
Gers	NPP
Giancardo	NPP
Giga	NPP
Gilles	NPP
Girard	NPP
Giscard	NPP
Giuly	NPP
Globalement	ADV
Goeudevert	NPP
Goldorak	NC
Golfe	NC
Gomez	NPP
Gorbatchev	NPP
Grande_-_Bretagne	NPP
Grandin	NPP
Gros	NPP
Grunelius	NPP
Grâce_à	P
Guitton	NPP
Gutmann	NPP
Gyver	NPP
Générale	NC
Généval	NPP
HLM	NC
Haberer	NPP
Hachette	NPP
Hafnia	NPP
Harold	NPP
Hata	NPP
Haute	ADJ
Haute_-_Marne	NPP
Haute_-_Savoie	NPP
Hauts_-_de_-_Seine	NPP
Heilbronner	NPP
Helmut	NPP
Henri	NPP
Hersant	NPP
Heseltine	NPP
Honda	NPP
Hongrie	NPP
Hors	P
Hubert	NPP
Huit	DET
IDC	NPP
IFIL	NPP
IG	NPP
INSEE	NPP
Iberia	NPP
Il	CLS
Il_y_a	P
Il_y_a	V
Ile_-_de_-_France	NPP
Illoud	NPP
Ils	CLS
Image	V
In_fine	ADV
Inaugurant	VPR
Indigence	NC
Industrial_bank_of_Japan	NPP
Industrie	NPP
Industries	NC
Inspecteur	NC
Installé	VPP
Institute	NC
Inter	ADJ
Intercontinental	NPP
Intervenant	VPR
Italie	NPP
Italiens	NC
Iveco	NPP
Izvestia	NPP
J	NC
JEF	NPP
Jack	NPP
Jacob	NPP
Jacobs	NPP
Jacques	NPP
Jan	NPP
Janeiro	NPP
Japon	NC
Japon	NPP
Japonais	NC
Je	CLS
Jean	NPP
Jean_-_Benoit	NPP
Jean_-_Claude	NPP
Jean_-_Daniel	NPP
Jean_-_François	NPP
Jean_-_Jacques	NPP
Jean_-_Louis	NPP
Jean_-_Luc	NPP
Jean_-_Marie	NPP
Jean_-_Michel	NPP
Jean_-_Noël	NPP
Jean_-_Paul	NPP
Jean_-_Pierre	NPP
Jean_-_René	NPP
Jean_-_Yves	NPP
Jerzy	NPP
John	NPP
Josèphe	NPP
Journal	NC
Joxe	NPP
Juillet	NPP
Jusqu'_au_bout	ADV
Jusqu'_à_présent	ADV
Jérôme	NPP
Kahn	NPP
Karl	NPP
Karmitz	NPP
Keller	NPP
L'	DET
LA	DET
LEBAUBE	NPP
LIMOGES	NPP
LRM	NPP
LUXEMBOURG	NPP
La	DET
Lafont	NPP
Lagardère	NPP
Laigneau	NPP
Lajeunesse	NPP
Lamont	NPP
Lamotte	NPP
Lang	NPP
Laurent	NPP
Laval	NPP
Le	DET
Lebègue	NPP
Leclerc	NPP
Ledru	NPP
Lefebvre	NPP
Lequel	PROWH
Les	DET
Leszek	NPP
Lettre	NC
Leur	DET
Lever	NPP
Liaz	NPP
Libération	NC
Liliane	NPP
Lille	NPP
Lin	NPP
Lion	NPP
Lire	VINF
Loin_de	P
Londres	NPP
Lorentz	NPP
Lorraine	NPP
Lors_d'	P
Lors_de	P
Louis	NPP
Lourdes	NPP
Loïk	NPP
Lufthansa	NPP
Lunéville	NPP
Lurçat	NPP
Luxembourg	NPP
Lyon	NPP
Là	ADV
Là_encore	ADV
Lévi	NPP
Lévy	NPP
M	NPP
M.	NC
MBB	NPP
MITI	NPP
MK2	NPP
MM.	NC
MMB	NPP
MOSCOU	NPP
Ma_sorcière_bien_aimée	NPP
Maastricht	NPP
Mac	NPP
Macmillan	NPP
Madinier	NPP
Maillot	NPP
Mainishi	NPP
Mais	CC
Maison	NC
Major	NPP
Malgré	P
Malheureusement	ADV
Mamie	NPP
Manche	NC
Mandag	ET
Margaux	NPP
Marie	NPP
Marie_-_Claude	NPP
Mariet	NPP
Marin	NPP
Maritime	NPP
Marne	NPP
Marseillaise	NPP
Martine	NPP
Martre	NPP
Marx	NPP
Matignon	NPP
Matouk	NPP
Matra	NPP
Matuikhin	NPP
Maurice	NPP
Maurisson	NPP
Mauroy	NPP
Mauvais	ADJ
Maxwell	NPP
Mayenne	NC
Mazda	NPP
Mazeaud	NPP
Me	NC
Meisonnier	NPP
Meissonnier	NPP
Mellick	NPP
Mentzelopoulos	NPP
Mercadé	NPP
Mercedes	NPP
Mercedes_-_Benz	NPP
Mercedes_-_Benz_AG	NPP
Mermaz	NPP
Metall	NPP
Mettant	VPR
Meule	NC
Meurthe_-_et_-_Moselle	NPP
Mexique	NPP
Michael	NPP
Michel	NPP
Michel_-_Edouard	NPP
Milan	NPP
Minitel	NC
Mireille	NPP
Mis	V
Mitsubishi	NPP
Mitterrand	NPP
Miyazawa	NPP
Mlada	NPP
Mme	NC
Mme	NPP
Mobilité	NC
Monde	NPP
Monod	NPP
Monopoly	NPP
Moravie	NPP
Morgen	ET
Morin	NPP
Morlaix	NPP
Moscou	NPP
Motors	NPP
Moulard	NPP
Moulins	NC
Mourmelon	NPP
Munich	NPP
Mutualité	NC
Mâcon	NPP
Médiaspouvoirs	NPP
Ménage	NPP
Météo_-_France	NPP
Même	ADV
Même_si	CS
NEDC	NPP
NHS	NPP
Nam	NPP
Nantes	NPP
Naville	NPP
Naître_et_grandir	NPP
Neddy	NPP
Nestlé	NPP
New_-_Hampshire	NPP
New_-_York	NPP
Nicholls	NPP
Nickelodeon	NPP
Nicolas	NPP
Nippon	ET
Non	ADV
Nord	NPP
Norman	NPP
Normand	NPP
Normandie	NPP
Northern	NPP
Notre	DET
Nounours	NPP
Nous	CLS
Nouveau	ADJ
Nouvel	ADJ
Nouvelle	ADJ
Nova	ET
Noël	NPP
Nul	DET
OCDE	NC
OP	NPP
OPA	NC
OPFI	NPP
OPZZ	NPP
OS	NPP
Objectif	NC
Observateur	NC
Office	NC
Olszewski	NPP
Ominco	NPP
On	CLS
Onze	DET
Opération	NC
Or	CC
Or	NC
Orsay	NPP
Ou	CC
Ouest	NC
Ouest	NPP
Oui	ADV
Outre	P
Ouvrière	NPP
Oxbridge	ET
Oxford	ET
Où	ADVWH
PAC	NPP
PAP	NPP
PDG	NC
PENDANT	P
PIB	NC
PME	NC
PNB	NC
PRAGUE	NPP
PS	NPP
PUF	NPP
P_et_T	NPP
Pache	NPP
Paix	NC
Par	P
Parallèlement	ADV
Parfois	ADV
Paribas	NPP
Paris	NPP
Parlement	NC
Parmi	P
Partant	VPR
Parti	NC
Pascal	NPP
Pasqua	NPP
Passés	VPP
Pat	NPP
Pau	NPP
Pauvre	ADJ
Pauvres	ADJ
Pays_-_Bas	NPP
Pechiney	NPP
Pellerin	NPP
Pen	NPP
Pendant	P
Perrier	NPP
Personne	PRO
Perte	NC
Petit	ADJ
Petroleum	NPP
Peu	ADV
Peut_-_être	ADV
Peyrelevade	NPP
Philippe	NPP
Pierre	NPP
Pimprenelle	NPP
Pis	ADV
Plan	NC
Plus	ADV
Plus_que	ADV
Pollena	NPP
Pologne	NPP
Polska	NPP
Pons	NPP
Ponthieux	NPP
Post	NPP
Poste	NC
Pour	P
Pour_la_première_fois	ADV
Pourquoi	ADVWH
Pourtant	ADV
Prague	NPP
Prigent	NPP
Principal	ADJ
Prochain	ADJ
Professeur	NC
Projects	NPP
Propos	NC
Présentées	VPP
Président	NPP
Prêts	ADJ
Puis	CC
Pyrénées	NPP
Qu'	CS
Qu'	PROWH
Quai	NC
Quand	ADVWH
Quand	CS
Quant_au	P
Quant_aux	P
Quant_à	P
Quatre	DET
Que	CS
Que	PROWH
Quelle	DETWH
Quelles	PROWH
Quelques	DET
Quels	DETWH
Qui	PROREL
Qui	PROWH
Quoi	PROWH
R	NPP
RATP	NPP
RDA	NPP
RFA	NPP
RMI	NC
RPR	NC
RVI	NPP
Rallye	NPP
Ramé	NPP
Rausch	NPP
Ray	NPP
Raymond	NPP
Recette	NC
Reconnaissant	VPR
Reliquet	NPP
Renault	NPP
Renault_véhicules_industriels	NPP
René	NPP
Resserrant	VPR
Revalorisé	VPP
Review	ET
Reynier	NPP
Rhône	NPP
Rhône_-_Poulenc	NPP
Riboud	NPP
Rio	NPP
Rivoli	NPP
Robert	NPP
Roland	NPP
Rollat	NPP
Rombas	NPP
Royal	NPP
Rue	NC
Ruhr	NPP
Rungis	NC
Russes	NC
Russie	NPP
Réagissant	VPR
Réduire	VINF
Réduite	VPP
Régnier	NPP
Régniere	NPP
Répondant	VPR
République	NPP
Républiques	NC
S'	CLR
S'	CS
SA	NC
SARI	NPP
SAS	NPP
SEM	NPP
SGF	NPP
SGS	NPP
SGS_-_Thomson	NPP
SIVP	NPP
SME	NPP
SMIC	NC
SNCF	NC
SOFRES	NPP
Saint	ADJ
Salinas	NPP
Salomon	NPP
Samuel	NPP
Sanofi	NPP
Sans	P
Sans_doute	ADV
Santilli	NPP
Sapin	NPP
Sartrouville	NPP
Satory	NPP
Saviem	NPP
Saône_-_et_-_Loire	NPP
Scalbert	NPP
Scandinavie	NPP
Schweitzer	NPP
Selon	P
Sensibilités	NC
Sept	DET
Serait	V
Seule	ADJ
Seulement	ADV
Seuls	ADJ
Seydoux	NPP
Sharry	NPP
Si	CS
Silvio	NPP
Singapore	ET
Sinon	ADV
Sir	NC
Skandia	NPP
Skoda	NPP
Smith	NPP
Société	NC
Socpresse	NPP
Sodiaal	NPP
Solidarité	NC
Solution	NC
Son	DET
Sophie	NPP
Souchon	NPP
Sous	P
Sous_-_traités	VPP
Statistical	ET
Steinkühler	NPP
Stern	NPP
Strauss	NPP
Strauss_-_Kahn	NPP
Street	ET
Suchard	NPP
Suez	NPP
Super	NC
Supposons	V
Sur	P
Surtout	ADV
Sécu	NPP
Ségolène	NPP
Sénat	NC
TF	NC
TGV	NC
TOKYO	NPP
TOM	NPP
TRAVAIL	NC
TUC	NPP
TV	NC
TVA	NC
Tapie	NPP
Tardivon	NPP
Tarzan	NPP
Tatra	NPP
Tchécoslovaquie	NPP
Ted	NPP
Telecom	NPP
Teochew	NPP
Teulade	NPP
Thatcher	NPP
The	ET
Thomas	NPP
Thomson	NPP
Thomson_-_CSF	NPP
Tokyo	NPP
Tonnerre	NPP
Totalisant	VPR
Toujours	ADV
Toulouse	NPP
Touraine	NPP
Tout	ADJ
Tout	ADV
Tout	PRO
Tout_-_Paris	NC
Tout_au_long_de	P
Tout_d'_abord	ADV
Tout_de_même	ADV
Toutefois	ADV
Toyota	NPP
Transparence	NC
Trichet	NPP
Trois	DET
Troyes	NPP
Trust	NPP
Trésor	NC
Trésor	NPP
Tu	CLS
Tupolev_-_134	NC
Télérama	NPP
U	NC
UAP	NC
UDC	NPP
UDF	NPP
UEM	NPP
UHP	NPP
ULN	NPP
UNEDIC	NPP
URSS	NPP
URSSAF	NPP
Un	DET
Une	DET
Une	NPP
Unilever	NPP
Union	NC
Union	NPP
Uruguay	NPP
VARSOVIE	NPP
VEV	NPP
VMTV	NPP
Val_-_de_-_Marne	NPP
Valence	NPP
Varsovie	NPP
Vaucluse	NPP
Velasquez	NPP
Vendredi	NC
Verdun	NPP
Vergèze	NPP
Veszprem	NPP
Victoire	NPP
Vie	NC
Vincent	NPP
Vingt_et_une	DET
Vnesheconombank	NPP
Voici	V
Voilà	V
Volkswagen	NPP
Volski	NPP
Volvo	NPP
Vous	CLS
Vu	VPP
Wall	ET
Washington	NPP
Weber	NPP
Werner	NPP
Worms	NPP
Worms_et_Cie	NPP
XIIIe	NPP
XIX	NPP
Yoplait	NPP
Youpi_!	NPP
Youpi_l'_école_est_finie	NPP
Youppie	I
Yvelines	NPP
Yves	NPP
Zorro	NPP
Zygomusic	NPP
[	PONCT
]	PONCT
a	V
a_posteriori	ADJ
a_priori	ADV
abandon	NC
abandonnant	VPR
abandonné	VPP
abattement	NC
abonnés	NC
aboutira	V
aboutissant	VPR
abri	NC
abréviation	NC
absence	NC
absent	ADJ
absorbé	VPP
absorption	NC
absoudre	VINF
abuser	VINF
académie	NC
accalmie	NC
accent	NC
accentuent	V
acceptable	ADJ
acceptant	VPR
acceptation	NC
accepter	VINF
acceptera	V
accepteraient	V
accepterait	V
accepté	VPP
acceptée	VPP
accession	NC
accident	NC
accidents	NC
accompagnement	NC
accompagnent	V
accord	NC
accordait	V
accordant	VPR
accorder	VINF
accords	NC
accordé	VPP
accordée	VPP
accouché	VPP
accrochages	NC
accroissement	NC
accroître	VINF
accrue	ADJ
accrues	ADJ
accueil	NC
accueillie	VPP
accueillies	VPP
accueillir	VINF
accumulées	VPP
accumulés	VPP
accuse	V
accusé	VPP
accusée	VPP
accès	NC
accéder	VINF
accélération	NC
accélérer	VINF
acharnement	NC
acharner	VINF
acharnée	ADJ
achat	NC
achats	NC
achemine	V
acheminer	VINF
acheter	VINF
acheteurs	NC
acheté	VPP
achetées	VPP
achever	VINF
achevé	VPP
acier	NC
acquis	ADJ
acquis	VPP
acquise	ADJ
acquisitions	NC
acquitte	V
acquittent	V
acquéreur	NC
acquérir	VINF
acte	NC
actes	NC
acteur	NC
acteurs	NC
actif	ADJ
actif	NC
actifs	NC
action	NC
actionnaire	NC
actionnaires	NC
actionnariat	NC
actions	NC
active	ADJ
activité	NC
activités	NC
actualités	NC
actuel	ADJ
actuelle	ADJ
actuellement	ADV
actuelles	ADJ
actuels	ADJ
acuité	NC
adaptation	NC
adapter	VINF
adapté	ADJ
adhérences	NC
adhérents	NC
adjoint	ADJ
adjudications	NC
admet	V
admettent	V
admettre	VINF
administrateur	NC
administrateurs	NC
administratifs	ADJ
administration	NC
administrative	ADJ
administratives	ADJ
admirait	V
admirent	VS
admis	VPP
adolescents	NC
adoptées	VPP
ados	NC
adresser	VINF
adressée	ADJ
adulte	NC
adultes	NC
advienne	VS
affaibli	VPP
affaiblir	VINF
affaire	NC
affaires	NC
affectant	VPR
affecté	VPP
affichant	VPR
afficher	VINF
affirmant	VPR
affirme	V
affirment	V
affirmer	VINF
affirmé	VPP
affluence	NC
affranchir	VINF
affronter	VINF
afin	CS
afin	P
afin_d'	P
afin_de	P
agence	NC
agent	NC
agents	NC
aggravation	NC
agi	VPP
agir	VINF
agira	V
agirait	V
agissant	VPR
agisse	VS
agit	V
agitation	NC
agités	ADJ
agression	NC
agressive	ADJ
agressivité	NC
agricole	ADJ
agricoles	ADJ
agriculteur	NC
agriculteurs	NC
agriculture	NC
agro_-_alimentaires	ADJ
agroalimentaire	ADJ
agroalimentaire	NC
agroalimentaires	ADJ
agrément	NC
agréée	ADJ
ai	V
aide	NC
aider	VINF
aides	NC
aidé	VPP
aient	VS
aimeraient	V
ainsi	ADV
ainsi_qu'	CC
ainsi_que	CC
ainsi_que	CS
air	NC
aisément	ADV
ait	VS
ajoutant	VPR
ajoute	V
ajoutent	V
ajouter	VINF
ajouterait	V
ajoutons	V
ajouté	VPP
ajoutée	ADJ
ajustés	VPP
alarme	NC
alarmer	VINF
alcool	NC
alcoolisme	NC
alentours	NC
alimentaires	ADJ
alimentant	VPR
alimentation	NC
alinéa	NC
aliénation	NC
allaient	V
allait	V
allaitante	ADJ
allant	VPR
allemand	ADJ
allemande	ADJ
allemands	ADJ
aller	VINF
alliance	NC
allier	VINF
allié	NC
allocation	NC
allocations	NC
allongement	NC
allongés	VPP
allons	V
alloués	VPP
allègements	NC
allée	VPP
allégée	VPP
alors	ADV
alors_même_que	CS
alors_qu'	CS
alors_que	CS
alourdir	VINF
altération	NC
amalgame	NC
ambiance	NC
ambiante	ADJ
ambiguïté	NC
ambiguïtés	NC
ambitions	NC
amende	NC
amendes	NC
amener	VINF
amené	VPP
amer	ADJ
amical	ADJ
amicale	NC
amicalement	ADV
amicales	ADJ
amis	NC
amorcer	VINF
amorcée	VPP
amorphe	ADJ
amples	ADJ
ampleur	NC
amplifient	V
amputation	NC
amélioration	NC
améliorations	NC
améliorer	VINF
amélioré	VPP
améliorées	VPP
aménagement	NC
américain	ADJ
américaine	ADJ
américaines	ADJ
américains	ADJ
an	NC
anachronique	ADJ
analyse	NC
analyse	V
analysés	VPP
anarchique	ADJ
ancien	ADJ
ancienne	ADJ
anciennement	ADV
anciens	ADJ
anciens	NC
ancre	NC
and	ET
anglaise	ADJ
angle	NC
anglo_-_américaine	ADJ
anglo_-_néerlandaise	ADJ
anicroches	NC
animation	NC
animations	NC
animaux	NC
animer	VINF
animé	ADJ
animé	VPP
animés	ADJ
anniversaire	NC
annonce	NC
annonce	V
annoncerait	V
annonces	NC
annoncé	VPP
annoncée	VPP
annoncées	VPP
annoncés	VPP
annonça	V
annonçant	VPR
annuel	ADJ
annuelles	ADJ
année	ADJ
année	NC
années	NC
ans	NC
antenne	NC
anticipations	NC
anticiper	VINF
antérieure	ADJ
anxiété	NC
août	NC
apaiser	VINF
apanage	NC
apparaissaient	V
apparaissent	V
apparaît	V
apparaîtra	V
apparaître	VINF
appareil	NC
appareils	NC
apparemment	ADV
apparent	ADJ
apparente	ADJ
apparente	V
apparentent	VS
apparition	NC
appartenait	V
appartenu	VPP
appel	NC
appelle	V
appelé	VPP
appelées	VPP
appelés	VPP
application	NC
applique	V
appliquer	VINF
appliquera	V
appliquée	VPP
apporte	V
apportent	V
apporter	VINF
apportées	VPP
apprentis	NC
apprentissage	NC
approbation	NC
approche	NC
approfondi	VPP
approfondie	ADJ
approfondissement	NC
approfondit	V
approprier	VINF
approuver	VINF
approvisionne	V
appréciable	ADJ
appréciation	NC
apprécierait	V
apprécié	VPP
appréciée	VPP
appréhender	VINF
apprêtait	V
appuis_-_tête	NC
appuyer	VINF
appuyé	VPP
appâts	NC
après	ADV
après	P
après_-_midi	NC
aptitudes	NC
arbitrage	NC
arbitrages	NC
arbitre	NC
argent	NC
argentiers	NC
arguant	VPR
argument	NC
arguments	NC
armada	NC
armement	NC
armements	NC
armes	NC
armée	NC
arrange	V
arrivaient	V
arrivants	NC
arrivé	VPP
arrivée	NC
arrondissement	NC
arrondit	V
arrêt	NC
arrête	V
arrêter	VINF
arrêts	NC
arrêté	NC
arrêtées	ADJ
arrêtées	VPP
art.	NC
article	NC
articles	NC
artificiellement	ADV
artisanat	NC
artisans	NC
ascension	NC
aseptisé	VPP
aspect	NC
aspiration	NC
assaut	NC
assemblés	VPP
asservi	VPP
assez	ADV
assimilé	VPP
assistait	V
assistance	NC
assistante	NC
assiste	V
assisté	VPP
assistée	ADJ
assit	V
assiégée	VPP
association	NC
associations	NC
associer	VINF
associé	VPP
associées	VPP
assorties	VPP
assouplissement	NC
assumant	VPR
assume	V
assumer	VINF
assurance	NC
assurance_-_chômage	NC
assurance_-_maladie	NC
assurances	NC
assure	V
assurer	VINF
assureur	NC
assuré	VPP
assurées	ADJ
assurés	VPP
astuce	NC
astuces	NC
ateliers	NC
atout	NC
atouts	NC
atrophie	V
attachement	NC
attaché	VPP
attachée	VPP
attachés	VPP
attaquant	NC
attaqué	VPP
atteignait	V
atteignent	V
atteindrait	V
atteindre	VINF
atteindront	V
atteint	ADJ
atteint	V
atteint	VPP
atteinte	NC
attend	V
attendant	VPR
attendre	VINF
attendu	VPP
attente	NC
attention	NC
atteste	V
attirer	VINF
attitude	NC
attractif	ADJ
attribuent	V
atténuation	NC
atténué	VPP
atypique	ADJ
au_-_delà_de	P
au_-_delà_des	P
au_-_dessous_de	P
au_-_dessus_du	P
au_bord_du	P
au_bout_de	P
au_cas_par_cas	ADV
au_cours_de	P
au_cours_des	P
au_cours_du	P
au_début_des	P
au_lendemain_de	P
au_lieu_d'	P
au_lieu_des	P
au_lieu_du	P
au_moins	ADV
au_noir	ADV
au_nom_de	P
au_plus_fort_de	P
au_prix_de	P
au_quotidien	ADV
au_sein_d'	P
au_sein_de	P
au_sein_du	P
au_sens_de	P
au_soir	ADV
au_terme	P
au_terme_d'	P
au_titre_de	P
au_vu_des	P
aucun	DET
aucune	DET
audience	NC
audiovisuel	ADJ
audiovisuel	NC
audiovisuels	ADJ
audits	NC
augmentation	NC
augmentations	NC
augmente	V
augmenter	VINF
augmentera	V
augmenteront	V
augmenté	VPP
augmentée	VPP
augmentées	VPP
augure	V
aujourd'_hui	ADV
auparavant	ADV
auprès_d'	P
auprès_de	P
auprès_des	P
aura	V
auraient	V
aurais	V
aurait	V
auront	V
aussi	ADV
aussi_bien	ADV
austérité	NC
autant	ADV
auteur	NC
auteurs	NC
autocontrôle	NC
autogestion	NC
automates	NC
automatisation	NC
automne	NC
automobile	ADJ
automobile	NC
automobiles	ADJ
automobiles	NC
automobilistes	NC
autonomes	ADJ
autonomie	NC
autorisait	V
autorisant	VPR
autorisé	VPP
autorisée	VPP
autorisés	VPP
autoritaire	ADJ
autorité	NC
autorités	NC
autoroute	NC
autoroutes	NC
autour_de	P
autour_du	P
autre	ADJ
autre	PRO
autrement	ADV
autres	ADJ
autres	PRO
avaient	V
avait	V
avances	NC
avancées	VPP
avant	P
avant_de	P
avantage	NC
avantagerait	V
avantages	NC
avec	P
avenants	NC
avenir	NC
aveu	NC
avez	V
aviation	NC
aviez	V
avionique	NC
avions	NC
avis	NC
aviser	VINF
avisés	VPP
avoir	NC
avoir	VINF
avons	V
avoue	V
avril	NC
axe	NC
axes	NC
ayant	VPR
aérienne	ADJ
aérés	ADJ
baby_-_sitter	NC
bafoué	VPP
bailleur	NC
baisse	NC
baisse	V
baisser	NC
baisser	VINF
baissera	V
baisses	NC
baissé	VPP
balbutiante	ADJ
bambins	NC
banal	ADJ
banane	NC
bancaire	ADJ
bancaires	ADJ
bande	NC
bank	ET
banlieue	NC
bannir	VINF
banque	NC
banques	NC
banquier	NC
banquiers	NC
bar	NC
barbarisants	ADJ
baril	NC
barils	NC
barrage	NC
barrages	NC
barrent	V
barrer	VINF
barrières	NC
barème	NC
bas	ADJ
base	NC
bases	NC
bassin	NC
basés	VPP
bataille	NC
batailles	NC
bateaux	NC
battant	VPR
battre	VINF
battu	VPP
baume	NC
beaucoup	ADV
beaucoup	PRO
beauté	NC
belle	ADJ
belles	ADJ
berrichon	ADJ
besoin	NC
besoins	NC
beurre	NC
biais	NC
bien	ADJ
bien	ADV
bien_-_fondé	NC
bien_qu'	CS
bien_sûr	ADV
bienfaits	NC
biens	NC
bientôt	ADV
bienveillant	ADJ
bilan	NC
bilans	NC
bilatérales	ADJ
bilatéraux	ADJ
bière	NC
blanchiment	NC
blessé	VPP
bleus	ADJ
bloc	NC
blocage	NC
blocages	NC
blocus	NC
blonde	ADJ
bloquant	VPR
bloque	V
bloquées	VPP
bon	ADJ
bon_an_mal_an	ADV
bond	NC
bondi	VPP
bonne	ADJ
bonne	NC
bonnes	ADJ
bons	ADJ
boom	NC
bord	NC
bordelaise	ADJ
bouchant	VPR
bouche	NC
bouclé	VPP
bouger	VINF
bougera	V
boulot	NC
bourse	NC
boursière	ADJ
boursières	ADJ
bout	NC
boutique	NC
boutiques	NC
branche	NC
branches	NC
branle_-_bas	NC
brassés	VPP
brebis	NC
brefs	ADJ
bricolage	NC
brillants	ADJ
brise	V
britannique	ADJ
britanniques	ADJ
bruitages	NC
brun	ADJ
brusque	ADJ
brusquer	VINF
brut	ADJ
brut	NC
brutale	ADJ
bruts	ADJ
brèche	NC
brève	ADJ
brésilien	ADJ
brûlé	VPP
budget	NC
budgets	NC
budgétaire	ADJ
budgétaires	ADJ
bulletin	NC
bulletins	NC
bureaucratiques	ADJ
but	NC
bute	V
butoir	NC
bâtie	VPP
bâtiment	NC
bébés	NC
bénéfice	NC
bénéficiaire	ADJ
bénéficiaires	ADJ
bénéficie	V
bénéficient	V
bénéficieront	V
bénéficié	VPP
bêtes	NC
c'	CLS
c'_est_-_à_-_dire	CC
c'_est_-_à_-_dire	P
c'_est_pourquoi	ADV
cabinet	NC
cadre	NC
cadre_Etat_-_caisses	NC
cadres	NC
cahier	NC
caisses	NC
calcul	NC
calculer	VINF
calculs	NC
calculé	VPP
calendrier	NC
calme	NC
calmer	VINF
camembert	NC
camion	NC
camionneurs	NC
camions	NC
camp	NC
campagne	NC
campagnes	NC
caméra	NC
canadien	ADJ
canadien	NC
candidat	NC
candidats	NC
cantons	NC
cap	NC
capable	ADJ
capacité	NC
capacités	NC
capital	NC
capitale	NC
capitulation	NC
captifs	ADJ
car	CC
caractère	NC
caractéristique	NC
caractéristiques	NC
carbure	V
caricature	NC
carie	NC
carnets	NC
carrière	NC
carte	NC
cas	NC
case	NC
castes	NC
catalogue	NC
catalogues	NC
catastrophe	NC
catégories	NC
cause	NC
ce	CLO
ce	CLS
ce	DET
ce	PRO
cela	PRO
celle	PRO
celles	PRO
cellule	NC
celui	PRO
celui_-_ci	PRO
censure	NC
censé	VPP
censés	ADJ
centaine	NC
centimes	NC
central	ADJ
centrale	ADJ
centrale	NC
centrales	ADJ
centraux	NC
centre	NC
centres	NC
centrifugeuse	NC
centré	VPP
cependant	ADV
certain	ADJ
certaine	ADJ
certainement	ADV
certaines	ADJ
certaines	DET
certaines	PRO
certains	DET
certains	PRO
certes	ADV
ces	DET
cessant	VPR
cesse	V
cesser	VINF
cession	NC
cet	DET
cette	DET
ceux	PRO
ceux_-_ci	PRO
chacun	PRO
chacune	PRO
chambardement	NC
chambre	NC
champ	NC
champs	NC
chance	NC
chancelante	ADJ
chancelier	NC
chances	NC
change	NC
changea	V
changement	NC
changements	NC
changent	V
changer	VINF
changes	NC
changé	VPP
changés	VPP
chantier	NC
chantée	VPP
chapitre	NC
chaque	DET
chaque_fois_que	CS
char	NC
charge	NC
chargeant	VPR
chargera	V
charges	NC
chargé	ADJ
chargé	VPP
chargée	VPP
chargées	VPP
chargés	VPP
charité	NC
chars	NC
chars_de_combat	NC
charte	NC
charter	ET
chasse	NC
chauffeurs	NC
chaîne	NC
chaînes	NC
chef	NC
chefs	NC
chefs_-_d'_oeuvre	NC
chemin	NC
cher	ADJ
chercher	VINF
chercheraient	V
chercheront	V
chercheurs	NC
chevaliers	NC
chevelure	NC
chez	P
chics	ADJ
chien	NC
chiffre	NC
chiffres	NC
chiffré	ADJ
chimie	NC
chimiques	ADJ
choc	NC
chocolat	NC
choisi	VPP
choisiraient	V
choix	NC
choqua	V
chose	NC
choses	NC
chronique	ADJ
chronique	NC
chronotachygraphes	NC
chute	NC
chuté	VPP
chère	ADJ
chômage	NC
chômeurs	NC
ci	ADV
cinq	ADJ
cinq	DET
cinq	PRO
cinquante	DET
cinquante_-_cinq	DET
cinquante_-_huit	DET
cinquante_-_quatre	DET
cinquième	ADJ
cinéastes	NC
cinématographique	ADJ
circonspection	NC
circonstances	NC
circuits	NC
circulaire	NC
circulation	NC
circuler	VINF
citaient	V
cite	V
citizen	ET
citoyen	NC
citoyens	NC
civil	ADJ
civiles	ADJ
clair	ADJ
claire	ADJ
clairement	ADV
clandestin	ADJ
clarification	NC
clarifient	V
clarifiée	VPP
classe	NC
classement	NC
classless_society	ET
classés	VPP
clauses	NC
clients	NC
climat	NC
clips	NC
clique	NC
clivage	NC
clés	NC
clés_en_main	ADJ
coalition	NC
coeur	NC
cogestion	NC
cohérence	NC
collaborateur	NC
collaboration	NC
collecte	NC
collectifs	ADJ
collection	NC
collective	ADJ
collectivement	ADV
collectivité	NC
collectivités	NC
collèges	NC
collé	VPP
colonne	NC
colorés	VPP
combat	NC
combattre	VINF
combien	ADVWH
combler	VINF
comblé	VPP
comité	NC
commandes	NC
commandite	NC
commandée	VPP
comme	ADV
comme	CC
comme	CS
comme	P
comme_avant	ADV
comme_si	CS
comme_ça	ADV
commence	V
commencent	V
commencé	VPP
comment	ADVWH
commenté	VPP
commentées	VPP
commençait	V
commerce	ET
commerce	NC
commercial	ADJ
commerciale	ADJ
commerciales	ADJ
commercialisation	NC
commercialise	V
commerciaux	ADJ
commerçants	NC
commises	VPP
commissaire	NC
commissariat	NC
commission	NC
commissions	NC
commun	ADJ
communautaire	ADJ
communautaires	ADJ
communauté	NC
commune	ADJ
communication	NC
communiquer	VINF
communiqué	NC
communiste	ADJ
communistes	ADJ
communs	ADJ
commutation	NC
compagnie	NC
comparative	ADJ
compare	V
comparé	VPP
compassion	NC
compensant	VPR
compensation	NC
compensatoires	ADJ
compenser	VINF
compensé	VPP
complaisance	NC
complet	ADJ
complexe	ADJ
complexes	ADJ
complexes	NC
complices	NC
complète	V
complètement	ADV
complémentaire	ADJ
complémentaires	ADJ
complétant	VPR
compléter	VINF
comporte	V
comporterait	V
composante	NC
composite	ADJ
composé	VPP
composée	VPP
comprenaient	V
comprend	V
comprendre	VINF
compression	NC
compris	VPP
comprise	VPP
comprises	VPP
compromettent	V
compromettre	VINF
compromis	NC
comptables	ADJ
compte	NC
compte	V
compte_tenu_de	P
compte_tenu_des	P
compte_tenu_du	P
compter	VINF
comptes	NC
comptoir	NC
compétence	NC
compétences	NC
compétentes	ADJ
compétitifs	ADJ
compétition	NC
compétitivité	NC
comédie	NC
concentration	NC
concentre	V
concept	NC
conception	NC
concernant	P
concerne	V
concerné	VPP
concernées	VPP
concernés	VPP
concert	NC
concertation	NC
concertée	ADJ
concession	NC
concessions	NC
concilier	VINF
conclu	VPP
concluent	V
conclure	VINF
conclusion	NC
conclut	V
concourant	VPR
concours	NC
concret	ADJ
concrets	ADJ
concrète	ADJ
concrètes	ADJ
concrétisé	VPP
concurrence	NC
concurrent	NC
concurrents	NC
concèderont	V
condamnation	NC
condamne	V
condamnent	V
condamné	VPP
condamnés	VPP
condition	NC
conditions	NC
conduire	VINF
conduisaient	V
conduit	VPP
conduites	VPP
confiait	V
confiance	NC
confiant	VPR
confidentiel	ADJ
confirmation	NC
confirme	V
confirmer	VINF
confirmé	VPP
confirmée	VPP
confiées	VPP
conflit	NC
conflits	NC
conforme	ADJ
conformes	ADJ
conformément	ADV
conforte	V
confrères	NC
confusion	NC
confère	V
confédération	NC
conférence	NC
conglomérat	NC
congrès	NC
conjoint	NC
conjoints	NC
conjoncture	NC
conjugaison	NC
connais	V
connaissances	NC
connaissent	V
connaît	V
connaîtra	V
connaître	VINF
connivence	NC
connu	ADJ
connu	VPP
connue	VPP
connues	ADJ
connus	VPP
consacraient	V
consacrée	VPP
conscience	NC
consciencieusement	ADV
conscient	ADJ
conseil	NPP
conseiller	NC
conseils	NC
consensuel	ADJ
consensus	NC
consentement	NC
consenties	VPP
conservateur	ADJ
conservateurs	ADJ
conserver	VINF
conserveront	V
considère	V
considèrent	V
considérable	ADJ
considérables	ADJ
considéré	VPP
consiste	V
consolidation	NC
consommateurs	NC
consommation	NC
consommer	VINF
consortium	NC
constamment	ADV
constance	NC
constat	NC
constater	VINF
constats	NC
constaté	VPP
consternation	NC
constituant	VPR
constitue	V
constituent	V
constituer	VINF
constitutif	ADJ
constitution	NC
constitutionnel	ADJ
constitutive	ADJ
constitué	VPP
constituée	VPP
constructeur	NC
constructeurs	NC
constructif	ADJ
construction	NC
construit	VPP
construits	VPP
consulter	VINF
consécutif	ADJ
consécutive	ADJ
conséquence	NC
conséquences	NC
contact	NC
contacts	NC
contagieuse	ADJ
contentant	VPR
contente	V
contenter	VINF
contentieux	NC
contenté	VPP
contenu	NC
contestable	ADJ
contestaient	V
contestation	NC
contestées	VPP
continents	NC
continuation	NC
continue	ADJ
continue	V
continuent	V
continuer	VINF
continuité	NC
contourner	VINF
contractuel	ADJ
contractuelle	ADJ
contraignante	ADJ
contraignent	V
contraint	VPP
contraintes	NC
contraire	ADJ
contraire	NC
contrairement_à	P
contrat	NC
contrats	NC
contrats_-_formation	NC
contre	ADV
contre	P
contre_-_pouvoir	NC
contrepartie	NC
contribue	V
contribuer	VINF
contribution	NC
contrôlant	VPR
contrôle	NC
contrôler	VINF
contrôlée	VPP
convaincre	VINF
convention	NC
conventionnel	ADJ
conventionnelles	ADJ
conventionnels	ADJ
convergences	NC
conversion	NC
convertibilité	NC
convertibles	ADJ
convocation	NC
conçu	VPP
conçue	VPP
coopératif	ADJ
coopération	NC
coopératives	NC
coordination	NC
coordonner	VINF
copie	NC
coproduction	NC
copropriétaire	NC
coquilles	NC
corporatismes	NC
corporatiste	ADJ
corporatistes	ADJ
corps	NC
correctionnel	ADJ
corresp.	NC
correspondance	NC
correspondant	NC
correspondant	VPR
corruption	NC
corvée	NC
costumes	NC
cotation	NC
cote	NC
coteries	NC
cotisation	NC
cotisations	NC
cotisent	V
cotée	VPP
cotées	ADJ
coup	NC
coupe	NC
couperet	NC
coupes	NC
couple	NC
coups	NC
cour	NC
courage	NC
courageuse	ADJ
courageuses	ADJ
courant	ADJ
courant	VPR
courante	ADJ
courants	NC
courir	VINF
couronner	VINF
couronnes	NC
courrier	NC
cours	NC
court	ADJ
court_-_circuite	V
courtage	NC
courts	ADJ
couverture	NC
couvre	V
couvrent	V
couvrira	V
coïncider	VINF
coût	NC
coûte	V
coûtera	V
coûteuse	ADJ
coûteux	ADJ
coûts	NC
coûté	VPP
craignent	V
craint	VPP
crainte	NC
craintes	NC
crampes	NC
credit	ET
creuser	VINF
creuset	NC
crime	NC
cris	NC
crise	NC
critiquant	VPR
critique	V
critiquent	V
critiques	ADJ
critiques	NC
critiqué	VPP
critères	NC
croire	VINF
croissance	NC
croissant	ADJ
croissante	ADJ
croissantes	ADJ
croissants	ADJ
croissent	V
croix	NC
croyaient	V
croyait	V
crucial	ADJ
création	NC
créations	NC
crédibilité	NC
crédibles	ADJ
crédit	NC
crédit_-_relais	NC
crédits	NC
créer	VINF
créera	V
créneau	NC
créé	VPP
créés	VPP
cubiste	ADJ
cueille	V
cueillies	VPP
cuirs	NC
cuisant	ADJ
cuisine	NC
cul_-_de_-_sac	NC
culpabilité	NC
culture	NC
culturel	ADJ
culturelle	ADJ
culturelles	ADJ
curieux	ADJ
cuvée	NC
câble	NC
câblée	ADJ
cédait	V
céder	VINF
cédé	VPP
cédées	VPP
céréales	NC
céréaliers	NC
céréalières	ADJ
cérémonie	NC
côté	NC
côtés	NC
d'	DET
d'	DETWH
d'	P
d'_Estaing	NPP
d'_abord	ADV
d'_ailleurs	ADV
d'_antan	ADJ
d'_autant_plus	ADV
d'_autre_part	ADV
d'_autres	DET
d'_autres	PRO
d'_emblée	ADV
d'_entre	P
d'_ici	P
d'_ici_à	P
d'_origine	ADV
d'_un_côté	ADV
d'_une_part	ADV
danger	NC
dangereuse	ADJ
dangereux	ADJ
danois	ADJ
danoise	ADJ
dans	P
dans_ce_sens	ADV
dans_l'_entourage_de	P
dans_l'_espoir_de	P
dans_l'_intérêt_des	P
dans_la_limite_de	P
dans_la_mesure_où	CS
dans_la_mouvance_d'	P
dans_le_cadre_d'	P
dans_le_cadre_du	P
dans_le_même_temps	ADV
dans_un_premier_temps	ADV
dans_une_large_mesure	ADV
date	NC
dates	NC
daté	VPP
dauphin	NC
davantage	ADV
davantage_d'	P
davantage_que	CS
de	DET
de	P
de_base	ADJ
de_côté	ADV
de_dos	ADV
de_fait	ADV
de_façon_à	P
de_l'	DET
de_l'_autre_côté_de	P
de_l'_ordre_de	P
de_la	DET
de_la_part_du	P
de_mise	ADV
de_moins_de	P
de_moitié	ADV
de_même	ADV
de_même_que	CS
de_nature_à	P
de_peur_de	P
de_plus	ADV
de_plus_en_plus	ADV
de_plus_que	P
de_préférence_à	P
de_qualité	ADV
de_services	ADV
de_série	ADV
de_taille	ADV
de_toute_façon	ADV
de_toutes_parts	ADV
debout	ADV
degrés	NC
demandaient	V
demandant	VPR
demande	NC
demande	V
demander	VINF
demandes	NC
demandé	VPP
demeurant	VPR
demeure	V
demi	ADJ
demi	NC
demie	ADJ
demie	NC
dent	NC
dentaire	ADJ
depuis	ADV
depuis	P
depuis_peu	ADV
derechef	ADV
dernier	ADJ
dernier	NC
derniers	ADJ
dernière	ADJ
dernière_en_date	NC
dernières	ADJ
des	DET
descendre	VINF
description	NC
desserts	NC
dessin	NC
dessins	NC
dessinées	VPP
destin	NC
destinations	NC
destiné	VPP
destinée	VPP
destinées	VPP
destinés	VPP
dette	NC
deutschemark	NC
deutschemarks	NC
deux	ADJ
deux	DET
deux	NC
deux	PRO
deux_cents	DET
deux_mille	DET
deuxième	ADJ
devaient	V
devait	V
devant	P
devant	VPR
devants	NC
devenait	V
devenir	NC
devenir	VINF
devenu	VPP
devenue	VPP
deviendra	V
deviendrait	V
devient	V
devise	NC
devises	NC
devoir	VINF
devoirs	NC
devra	V
devraient	V
devrait	V
devront	V
diable	NC
dialectique	ADJ
dialogue	NC
dictature	NC
didactique	ADJ
difficile	ADJ
difficiles	ADJ
difficulté	NC
difficultés	NC
diffusion	NC
diffusé	VPP
différemment	ADV
différence	NC
différences	NC
différentes	ADJ
différentes	DET
différents	ADJ
différé	ADJ
dimanche	NC
diminuer	VINF
diminueront	V
diminution	NC
diminué	VPP
diplômés	NC
dire	NC
dire	VINF
direct	ADJ
directement	ADV
directeur	ADJ
directeur	NC
directeurs	NC
direction	NC
directions	NC
directive	NC
directs	ADJ
dirige	V
dirigeants	NC
dirigé	VPP
dirigée	VPP
diront	V
disait	V
discipline	NC
disciplines	NC
discours	NC
discrets	ADJ
discrétion	NC
discussion	NC
discussions	NC
discuter	VINF
disparition	NC
disparités	NC
disparu	VPP
disperser	VINF
disponible	ADJ
disponibles	ADJ
disposant	VPR
dispose	V
dispositif	NC
disposition	NC
dispositions	NC
disques	NC
dissiper	VINF
distances	NC
distinction	NC
distribueront	V
distributeurs	NC
distribution	NC
dit	V
dite	VPP
dites	ADJ
dites	VPP
diverses	ADJ
diverses	DET
division	NC
divulgué	VPP
dix	ADJ
dix	DET
dix_-_huit	DET
dix_-_huit_mille	DET
dix_-_sept	DET
dix_-_septième	ADJ
dizaine	NC
dizaines	NC
dockers	NC
docks	NC
doctrine	NC
document	NC
documentation	NC
documents	NC
dogme	NC
doigt	NC
doit	V
doivent	V
dollar	NC
dollars	NC
domaine	NC
domestique	ADJ
domestiques	ADJ
domine	V
dominé	VPP
dommages	NC
donatrice	ADJ
donc	ADV
donna	V
donne	V
donnent	V
donner	VINF
donnera	V
données	VPP
dont	PROREL
dormir	VINF
dorénavant	ADV
dorés	ADJ
dossier	NC
dossiers	NC
dotations	NC
dote	V
doté	VPP
douane	NC
douanes	NC
double	ADJ
double	NC
double	V
doublement	ADV
doubler	VINF
doublé	VPP
douloureux	ADJ
doute	NC
douze	ADJ
douze	DET
draconiens	ADJ
dragon	NC
dragons	NC
drame	NC
drogue	NC
droit	NC
droite	NC
droits	NC
du	DET
du_fait_de	P
dues	VPP
dur	ADJ
durable	ADJ
durables	ADJ
durant	P
dure	ADJ
durée	NC
dynamisme	NC
dès	P
débarrasser	VINF
débat	NC
débattre	VINF
débaucher	VINF
débloquer	VINF
débloquera	V
déboires	NC
débouchera	V
débouché	VPP
début	NC
débuts	NC
débuté	VPP
décalage	NC
décembre	NC
décemment	ADV
décennie	NC
décennies	NC
décentralisation	NC
déception	NC
déchirer	VINF
décidait	V
décide	V
décidé	VPP
décidée	VPP
décidément	ADV
décision	NC
décisions	NC
déclarait	V
déclarations	NC
déclare	V
déclarer	VINF
déclaré	VPP
déclarée	VPP
déclarés	VPP
déclenché	VPP
décollage	NC
décomposition	NC
décor	NC
décors	NC
décourageant	ADJ
découvert	NC
découvert	VPP
découverte	NC
découvrir	VINF
décret	NC
décrire	VINF
décrochage	NC
décès	NC
dédicaces	NC
déduction	NC
déduire	VINF
déduisent	V
défaite	NC
défaveur	NC
défavorisées	ADJ
défection	NC
défende	VS
défense	NC
défensive	ADJ
déferlent	V
défiant	VPR
déficit	NC
déficitaire	ADJ
déficitaires	ADJ
déficits	NC
définies	VPP
définition	NC
déflation	NC
déformé	VPP
dégageant	VPR
dégradation	NC
dégrader	VINF
dégraissages	NC
dégénéré	VPP
déjà	ADV
délai	NC
délais	NC
délais_de_paiement	NC
délectant	VPR
délibérée	ADJ
délicat	ADJ
délicate	ADJ
délinquance	NC
délit	NC
délocalisation	NC
délégation	NC
délégué	ADJ
délégué	NC
délégués	NC
démagogie	NC
démarche	NC
démarches	NC
démenti	VPP
démentir	VINF
démission	NC
démocratique	ADJ
démons	NC
démontrent	V
démontrer	VINF
démontré	VPP
démultiplie	V
dénationalisation	NC
dénommé	VPP
dénommés	VPP
dénonce	V
dénoncer	VINF
dénonçaient	V
dénonçant	VPR
départ	NC
départementale	ADJ
départements	NC
départs	NC
dépassant	VPR
dépassent	V
dépasser	VINF
dépassée	ADJ
dépendra	V
dépens	NC
dépensaient	V
dépense	NC
dépense	V
dépenser	VINF
dépenses	NC
dépensé	VPP
dépensées	VPP
déplace	V
déplaçant	VPR
déplorable	ADJ
déplore	V
dépolitiser	VINF
déposaient	V
déposants	NC
déposer	VINF
dépossédées	VPP
déposé	VPP
dépouillé	VPP
dépourvus	ADJ
dépréciation	NC
député	NC
députés	NC
dépôt	NC
dépôts	NC
déqualification	NC
dérangea	V
dérapage	NC
dérapages	NC
dérobade	NC
dérogation	NC
déroulées	VPP
déroulés	VPP
désaccord	NC
désaccords	NC
désamorcé	VPP
désarmé	ADJ
désengagement	NC
désigné	VPP
désireux	ADJ
désirs	NC
désordonnés	ADJ
désorganiser	VINF
désorganisé	VPP
désormais	ADV
détachées	ADJ
détail	NC
détenait	V
détenant	VPR
détenir	VINF
détenteur	NC
détenu	VPP
détenues	VPP
déterminer	VINF
déterminisme	NC
déterminés	VPP
détiendra	V
détiennent	V
détient	V
détracteurs	NC
dévaluation	NC
développement	NC
développer	VINF
développé	VPP
développées	VPP
déversé	VPP
déçue	VPP
dû	VPP
dûment	ADV
eau	NC
eaux	NC
effectif	NC
effectifs	NC
effectivement	ADV
effectives	ADJ
effectué	VPP
effectuées	VPP
effectués	VPP
effet	NC
effets	NC
efficace	ADJ
efficacement	ADV
efficacité	NC
effondrement	NC
efforcent	V
effort	NC
efforts	NC
efforçant	VPR
elle	CLS
elle	PRO
elle_-_même	PRO
elles	CLS
elles	PRO
embauche	NC
embauchent	V
embauches	NC
embellie	NC
embrassant	VPR
embraye	V
emmenthal	NC
emmené	VPP
empire	NC
empiriquement	ADV
emploi	NC
emploie	V
emplois	NC
employeurs	NC
employée	NC
employés	NC
emporter	VINF
emporté	VPP
emprisonnement	NC
emprunt	NC
emprunte	V
emprunts	NC
empêche	V
empêcher	VINF
empêchera	V
empêché	VPP
empêtrés	VPP
en	CLO
en	P
en_accord_avec	P
en_apparence	ADV
en_aucun_cas	ADV
en_avant	ADV
en_baisse	ADV
en_baisse_de	P
en_cas_d'	P
en_cause	ADV
en_ce_qui_concerne	P
en_charge	ADV
en_commun	ADV
en_compte	ADV
en_compétition	ADV
en_connaissance_de_cause	ADV
en_cours	ADV
en_cours_d'	P
en_cours_de	P
en_deçà_de	P
en_deçà_du	P
en_dépit_de	P
en_dépit_du	P
en_désespoir_de_cause	ADV
en_effet	ADV
en_fait	ADV
en_faveur_de	P
en_faveur_des	P
en_fonction_de	P
en_fonction_des	P
en_fonction_du	P
en_grande_partie	ADV
en_guise_de	P
en_général	ADV
en_hausse	ADV
en_jeu	ADV
en_l'_espace_de	P
en_lumière	ADV
en_main	ADV
en_matière_d'	P
en_matière_de	P
en_moyenne	ADV
en_même_temps	ADV
en_même_temps_qu'	CS
en_même_temps_que	CS
en_nature	ADV
en_odeur_de_sainteté	ADV
en_otage	ADV
en_outre	ADV
en_particulier	ADV
en_partie	ADV
en_passant_par	P
en_perspective	ADV
en_place	ADV
en_porte_à_faux	ADV
en_principe	ADV
en_priorité	ADV
en_qualité_de	P
en_quelque_sorte	ADV
en_raison_de	P
en_relation_avec	P
en_relief	ADV
en_revanche	ADV
en_réseau	ADV
en_somme	ADV
en_tant_qu'	ADV
en_temps_et_en_heure	ADV
en_termes_de	P
en_tout_cas	ADV
en_train_de	P
en_tête_des	P
en_tête_du	P
en_valeur	ADV
en_vente	ADV
en_vigueur	ADV
en_voie_de	P
en_vrac	ADV
en_échec	ADV
enchaîner	VINF
enclins	ADJ
encore	ADV
encouragé	VPP
encouragée	VPP
encourir	VINF
encre	NC
endettement	NC
endettés	VPP
endroits	NC
enfance	NC
enfant	NC
enfantine	ADJ
enfants	NC
enfer	NC
enfermée	VPP
enfin	ADV
enfouis	V
engagements	NC
engagent	V
engager	VINF
engagé	VPP
engagée	ADJ
engagée	VPP
engagées	ADJ
engagées	VPP
enjeu	NC
enjoint	VPP
enquête	NC
enquête	V
enquêteurs	NC
enrayer	VINF
enregistrait	V
enregistrer	VINF
enregistré	VPP
enregistrée	VPP
enseignants	NC
ensemble	ADV
ensemble	NC
ensuite	ADV
entamer	VINF
entend	V
entendait	V
entendent	V
entendre	VINF
entendu	VPP
enterré	VPP
enthousiasme	NC
entier	ADJ
entité	NC
entourant	VPR
entravée	VPP
entraînant	VPR
entraîner	VINF
entre	P
entrefaites	NC
entregent	NC
entrepreneurs	NC
entreprise	NC
entreprises	NC
entrer	VINF
entretien	NC
entretiennent	V
entretiens	NC
entré	VPP
entré_en_vigueur	VPP
entrée	NC
entrées	NC
entrées	VPP
entériner	VINF
envenimer	VINF
envergure	NC
enverra	V
envie	NC
environ	ADV
environnement	NC
envisage	V
envisageons	V
envisager	VINF
envisagerait	V
envisagé	VPP
envisagée	VPP
envoyant	VPR
envoyé	NC
envoyée	NC
erreur	NC
erreurs	NC
escadron	NC
esclavage	NC
escompte	NC
espagnols	ADJ
espoir	NC
espoirs	NC
esprit	NC
espère	V
espérait	V
espérance	NC
espérant	VPR
espérer	VINF
essayer	VINF
essentiellement	ADV
essor	NC
est	NPP
est	V
estimaient	V
estimait	V
estimant	VPR
estimation	NC
estimations	NC
estime	V
estiment	V
estimer	VINF
estimez	V
estimé	VPP
estimée	VPP
estimés	VPP
estomac	NC
estuaire	NC
et	CC
et_même	CC
etc.	ADV
eu	V
eu	VPP
eu_lieu	VPP
européen	ADJ
européenne	ADJ
européennes	ADJ
européens	ADJ
eurosceptiques	NC
eux	PRO
eux_-_mêmes	PRO
ex	ET
ex-	PREF
exact	ADJ
exacte	ADJ
exactement	ADV
examen	NC
examiner	VINF
examiné	VPP
examinée	VPP
exception	NC
exceptionnel	ADJ
excessif	ADJ
exclus	VPP
exclusion	NC
exclusivement	ADV
excuser	VINF
excédent	NC
excédentaires	ADJ
exemplaire	ADJ
exemplaires	NC
exemple	NC
exempte	ADJ
exercer	VINF
exercice	NC
exercices	NC
exercé	VPP
exergue	NC
exigeant	ADJ
exigences	NC
exigent	V
exiger	VINF
exigerait	V
existant	ADJ
existants	ADJ
existe	V
existence	NC
existent	V
expansion	NC
expert	NC
expertise	NC
experts	NC
expiration	NC
explication	NC
explicitement	ADV
expliquant	VPR
explique	V
expliquent	V
expliquent	VS
expliquer	VINF
expliqueront	V
expliqué	VPP
exploitants	NC
exploitation	NC
exploitations	NC
exploités	VPP
explosent	V
explosion	NC
explosé	VPP
expo	NC
exportable	ADJ
exportateur	NC
exportateurs	ADJ
exportateurs	NC
exportation	NC
exportations	NC
exposition	NC
expovente	NC
expression	NC
exprimant	VPR
exprimer	VINF
exprimé	VPP
exprimées	VPP
expéditif	ADJ
expérience	NC
extension	NC
extraordinaire	ADJ
extrêmement	ADV
extérieur	ADJ
extérieur	NC
extérieure	ADJ
extérieures	ADJ
extérieurs	ADJ
exécution	NC
eût	VS
fabricants	NC
fabrication	NC
fabrique	V
face	NC
face_-_à_-_face	NC
face_à	P
facilement	ADV
facilitent	V
faciliter	VINF
facilitée	VPP
facilités	NC
facteurs	NC
facture	NC
faible	ADJ
faibles	ADJ
faiblesse	NC
faillite	NC
faim	NC
faire	NC
faire	VINF
faire_appel	VINF
faire_l'_objet	VINF
faire_pression	VINF
faire_preuve	VINF
faisait	V
faisant	VPR
fait	NC
fait	V
fait	VPP
fait_mine	V
fait_preuve	VPP
fait_suite	V
faite	VPP
faites	VPP
faits	NC
faits	VPP
fallait	V
falloir	VINF
fallu	VPP
fameuse	ADJ
familial	ADJ
familiale	ADJ
familiales	ADJ
familiaux	ADJ
familier	ADJ
famille	NC
familles	NC
fard	NC
fascisme	NC
fatidiques	ADJ
faudra	V
faudrait	V
fausser	VINF
faussé	VPP
faut	V
faute_de	P
favorable	ADJ
favorablement	ADV
favorables	ADJ
favorise	V
favorisent	V
favoriser	VINF
favorisé	VPP
façon	NC
femme	NC
femmes	NC
fera	V
ferait	V
fermement	ADV
fermeture	NC
fermeté	NC
fermée	VPP
feront	V
ferrées	ADJ
feu	NC
feuilles	NC
feuilletons	VIMP
ficelé	ADJ
fiche	V
fictive	ADJ
fidèle	NC
fidéliser	VINF
figuraient	V
figurait	V
figurent	VS
figés	VPP
files	NC
filiale	NC
filiales	NC
films	NC
fin	ADV
fin	NC
final	ADJ
finalement	ADV
finance	NC
financement	NC
financer	VINF
finances	NC
financier	ADJ
financiers	ADJ
financiers	NC
financière	ADJ
financièrement	ADV
financières	ADJ
fini	ADJ
finir	VINF
finissent	V
finit	V
finlandais	ADJ
fins	NC
firme	NC
firmes	NC
fiscal	ADJ
fiscale	ADJ
fiscales	ADJ
fiscaux	ADJ
fixe	ADJ
fixer	VINF
fixé	VPP
fixée	VPP
flair	NC
flatte	V
flatteuse	ADJ
flexibilité	NC
flexible	ADJ
florissante	ADJ
flot	NC
flotte	NC
flottement	NC
flou	NC
fluviales	ADJ
flux	NC
fléchissement	NC
fois	NC
fonction	NC
fonctionnaire	NC
fonctionnaires	NC
fonctionne	V
fonctionnement	NC
fonctionnent	V
fonctions	NC
fond	NC
fondamental	ADJ
fondateurs	ADJ
fondent	V
fonderie	NC
fonds	NC
fondé	VPP
font	V
font_l'_objet	V
forces	NC
forcé	VPP
forcées	ADJ
forcément	ADV
forgeron	NC
formalités	NC
formant	VPR
formation	NC
formats	NC
forme	NC
formel	ADJ
former	VINF
formes	NC
formidable	ADJ
formule	NC
formuler	VINF
formé	VPP
formée	VPP
formés	VPP
fort	ADJ
fort	ADV
forte	ADJ
fortement	ADV
fortes	ADJ
fortifient	V
forts	ADJ
forts	NC
forum	NC
forêt	NC
foudres	NC
fougue	NC
fourchette	NC
fournier	NC
fournisse	VS
fournisseurs	NC
fournit	V
fragile	ADJ
fragilité	NC
frais	NC
franc	NC
franchir	VINF
franchissement	NC
franco_-_britannique	ADJ
franco_-_française	ADJ
franco_-_italiens	ADJ
francophobie	NC
francs	NC
français	ADJ
français	NC
française	ADJ
françaises	ADJ
frappés	VPP
fraudes	NC
frauduleuses	ADJ
freins	NC
fromage	NC
fromager	ADJ
frontières	NC
frotte	V
fruit	NC
fréquent	ADJ
fréquentation	NC
fumier	NC
fusils	NC
fusion	NC
fusionné	VPP
fusions	NC
fut	V
futur	ADJ
futur	NC
fébrilement	ADV
fédéral	ADJ
fédération	NC
fédérations	NC
fédéré	VPP
félicite	V
félicité	VPP
février	NC
gadget	NC
gage	NC
gagnaient	V
gagne	V
gagné	VPP
gain	NC
gains	NC
galaxie	NC
gamberge	V
gamins	NC
gamme	NC
gammées	ADJ
garantie	ADJ
garantie	NC
garantir	VINF
garde	NC
gardent	V
garder	VINF
garderons	V
gardiens	NC
gars	NC
gaspillé	VPP
gauche	ADJ
gauche	NC
gel	NC
gelée	ADJ
gendarme	NC
gendarmerie	NC
genre	NC
genres	NC
gens	NC
geste	NC
gestion	NC
gestionnaires	NC
ghettos	NC
gisements	NC
glaces	NC
glissade	NC
glissement	NC
global	ADJ
globale	ADJ
globales	ADJ
globalisation	NC
gonfler	VINF
gosse	NC
goutte	NC
gouvernement	NC
gouvernemental	ADJ
gouvernementale	ADJ
gouvernementales	ADJ
gouvernementaux	ADJ
gouvernements	NC
gouverneur	NC
goût	NC
grand	ADJ
grand_-_chose	NC
grande	ADJ
grandes	ADJ
grandissante	ADJ
grandit	V
grands	ADJ
grands	NC
graphiques	NC
grave	ADJ
graves	ADJ
gravité	NC
grenade	NC
grenouille	NC
grille	NC
grilles	NC
grimpait	V
grimperont	V
grièvement	ADV
gros	ADJ
grosse	ADJ
groupe	NC
groupement	NC
groupements	NC
groupes	NC
grâce_aux	P
grâce_à	P
grâces	NC
grève	NC
grèves	NC
gré	NC
guerre	NC
guichets	NC
guère	ADV
guérilla	NC
gymnases	NC
gymnastique	NC
gâchis	NC
gâtées	VPP
géant	NC
gémit	V
génies	NC
général	ADJ
générale	ADJ
généralement	ADV
généralisation	NC
généralistes	ADJ
généralisée	VPP
génération	NC
généraux	ADJ
généraux	NC
gérant	VPR
gérer	VINF
géré	VPP
gêner	VINF
habilement	ADV
habitant	NC
habitent	V
habituel	ADJ
habituelle	ADJ
habituelles	ADJ
handicaps	NC
hardi	ADJ
hasard	NC
hausse	NC
hausses	NC
haussière	ADJ
haute	ADJ
hautement	ADV
hauts	ADJ
haïssent	V
hebdomadaire	ADJ
hebdomadaire	NC
hebdomadaires	NC
hectare	NC
herbagers	ADJ
heure	NC
heures	NC
heurte	V
heurtent	V
heurter	VINF
hexagone	NC
histoire	NC
historique	ADJ
historiques	ADJ
hiver	NC
hiérarchique	ADJ
holding	NC
holding_financier	NC
holdings	NC
homeless	ET
homme	NC
hommes	NC
homogénéisation	NC
homologation	NC
homologues	NC
hongrois	ADJ
honorer	VINF
honoré	VPP
horaire	ADJ
hormis	P
hors	ADV
hors_de	P
hospitaliers	ADJ
hospitalisation	NC
hospitalière	ADJ
hostiles	ADJ
hostilité	NC
huit	ADJ
huit	DET
huit_cents	DET
humaines	ADJ
humeur	NC
hyperinflation	NC
hypnotisé	VPP
hypocrisie	NC
hypothèses	NC
hâte	NC
hégémonique	ADJ
hélas	I
héritage	NC
hérité	VPP
héros	NC
hésitations	NC
hôpitaux	NC
hôtels	NC
ici	ADV
iconoclaste	ADJ
identifiés	VPP
identique	ADJ
identité	NC
idéale	ADJ
idéalisés	VPP
idée	NC
idéologique	ADJ
ignorance	NC
ignorant	VPR
ignore	V
ignorer	VINF
ignoré	VPP
il	CLS
il_est_vrai	ADV
il_y_a	P
il_y_a	V
illustrations	NC
illustre	V
ils	CLS
image	NC
images	NC
imaginaire	NC
imagination	NC
imaginé	VPP
immensité	NC
immeubles	NC
immigration	NC
imminent	ADJ
immobilier	ADJ
immobilisme	NC
immobilière	ADJ
immobilières	ADJ
immédiate	ADJ
immédiates	ADJ
immédiats	ADJ
imparfait	ADJ
impitoyable	ADJ
implantation	NC
impliquant	VPR
implique	V
impliqué	VPP
impopulaires	ADJ
impopularité	NC
importance	NC
important	ADJ
importante	ADJ
importantes	ADJ
importations	NC
importer	VINF
importés	VPP
imposable	ADJ
impose	V
imposent	V
imposer	VINF
impossibilité	NC
impossible	ADJ
imposé	VPP
imposée	VPP
impression	NC
improvisent	V
imprécises	ADJ
imprévu	ADJ
impuissance	NC
imputé	VPP
impôt	NC
impôts	NC
in_fine	ADV
inacceptables	ADJ
inachevé	ADJ
inactifs	NC
inapplicable	ADJ
inattaquable	ADJ
inauguré	VPP
incapable	ADJ
incapacité	NC
incertaine	ADJ
incertains	ADJ
incessante	ADJ
incessants	ADJ
incidence	NC
incitation	NC
incitatives	ADJ
incite	V
inciter	VINF
incliner	VINF
incluant	VPR
incombent	V
inconnu	ADJ
incontestable	ADJ
incontesté	ADJ
incriminé	VPP
indemnisation	NC
indemnité	NC
indemnités	NC
indicateurs	NC
indicative	ADJ
indice	NC
indigence	NC
indiquait	V
indique	V
indiqué	VPP
indirecte	ADJ
indirectement	ADV
indiscutable	ADJ
indispensable	ADJ
indistinctes	ADJ
individuelle	ADJ
individuellement	ADV
individuelles	ADJ
individuels	ADJ
individus	NC
induits	VPP
indulgence	NC
industrialisés	ADJ
industrialisés	VPP
industrie	NC
industriel	ADJ
industrielle	ADJ
industrielles	ADJ
industriels	ADJ
industriels	NC
industries	NC
industrieuse	ADJ
indéfinie	ADJ
indépendance	NC
indépendante	ADJ
indépendants	ADJ
indéracinable	ADJ
inenvisageables	ADJ
inespérée	ADJ
inexorablement	ADV
infini	ADJ
infiniment	ADV
inflation	NC
inflationniste	ADJ
inflexion	NC
infligées	VPP
influence	NC
influent	ADJ
influente	ADJ
infléchir	VINF
informant	VPR
information	NC
informations	NC
informatique	ADJ
informatique	NC
informée	VPP
infractions	NC
infructueuse	ADJ
infructueuses	ADJ
inférieur	ADJ
inférieure	ADJ
inférieures	ADJ
ingrédients	NC
ingénierie	NC
ingénieur	NC
initial	ADJ
initiative	NC
initiatives	NC
initiés	NC
injecte	V
injustement	ADV
innombrables	ADJ
inopinée	ADJ
inouï	ADJ
inquiet	ADJ
inquiète	V
inquiétaient	V
inquiétait	V
inquiétante	ADJ
inquiéter	VINF
inscrit	V
inscrit	VPP
inscrite	VPP
inscrits	ADJ
insertion	NC
insistaient	V
insoluble	ADJ
insolvable	ADJ
insoupçonnées	ADJ
inspecteur	NC
inspection	NC
inspira	V
inspire	V
inspirée	NC
installés	VPP
instance	NC
instant	NC
instauration	NC
institut	NC
instituteurs	NC
institutions	NC
institué	VPP
instrument	NC
insuffisamment	ADV
insuffisance	NC
insuffisante	ADJ
intellectuelles	ADJ
intelligence	NC
intelligentes	ADJ
intensifiait	V
intensifier	VINF
intentions	NC
inter	ADJ
interactifs	ADJ
interlocuteurs	NC
interministériel	ADJ
interministérielle	ADJ
intermédiaires	ADJ
intermédiaires	NC
international	ADJ
international	ET
international	NC
internationale	ADJ
internationales	ADJ
internationalisation	NC
internationaux	ADJ
interne	ADJ
internes	ADJ
interprofessionnel	ADJ
interprétation	NC
interprété	VPP
interprétée	VPP
interrogations	NC
interrogeait	V
interrogent	V
interrogé	VPP
interrogées	VPP
interrompre	VINF
interrompu	VPP
intersyndicale	ADJ
intervalle	NC
intervenant	VPR
intervention	NC
interventionnisme	NC
interventionniste	ADJ
intervenu	VPP
intervenue	VPP
intervenues	VPP
interviendrait	V
interviennent	V
intervient	V
intitulé	VPP
intoxication	NC
intra-	PREF
introduction	NC
introduire	VINF
introduit	VPP
introduite	VPP
intégralité	NC
intégrer	VINF
intéressante	ADJ
intéressent	V
intéressent	VS
intéresser	VINF
intéressés	NC
intérieur	ADJ
intérieure	ADJ
intérêt	NC
intérêts	NC
invalidées	VPP
inventaire	NC
inventer	VINF
inventé	VPP
inverse	NC
inverse	V
inverser	VINF
investi	VPP
investir	VINF
investissant	VPR
investissement	NC
investissements	NC
investisseurs	NC
invitant	VPR
invité	NC
invités	VPP
inégale	ADJ
inégalement	ADV
inégalité	NC
inégalités	NC
inépuisable	ADJ
inévitable	ADJ
inévitables	ADJ
irresponsable	ADJ
irrités	VPP
irréaliste	ADJ
irrégularité	NC
isolé	VPP
issu	VPP
issue	NC
issue	VPP
issus	VPP
italien	ADJ
italienne	ADJ
j'	CLS
jacqueries	NC
jamais	ADV
jambes	NC
janvier	NC
japonais	ADJ
japonais	NC
japonaise	ADJ
japonaises	ADJ
jardinage	NC
je	CLS
jette	VS
jeté	VPP
jeu	ADJ
jeu	NC
jeudi	NC
jeune	ADJ
jeunes	ADJ
jeunes	NC
jeunesse	NC
jeux	NC
joindre	VINF
joint	VPP
joint_-_venture	NC
joliment	ADV
joue	NC
jouer	VINF
jouet	NC
jour	NC
journal	NC
journalistes	NC
journaux	NC
journée	NC
journées	NC
jours	NC
joué	VPP
judiciaire	ADJ
juge	NC
juge	V
jugeaient	V
jugeant	VPR
jugement	NC
jugé	VPP
jugés	VPP
juillet	NC
juin	NC
jumeaux	NC
juridique	ADJ
juridiques	ADJ
jurisprudence	NC
jusqu'	P
jusqu'_aux	P
jusqu'_en	P
jusqu'_ici	ADV
jusqu'_à	P
jusqu'_à_présent	ADV
juste	ADJ
juste	ADV
justement	ADV
justice	NC
justifie	V
justifié	VPP
juxtaposition	NC
kids	NC
kilo	NC
kilomètres	NC
kilométrique	ADJ
l'	CLO
l'	DET
l'_on	CLS
l'_un	PRO
l'_île_-_de_-_France	NPP
l'on	CLS
la	CLO
la	DET
la_plupart_du	DET
la_veille	ADV
laborieusement	ADV
lacrymogène	ADJ
ladite	ADJ
laisser	VINF
laissez	V
laissé	VPP
laissé_entendre	VPP
laissée	VPP
lait	NC
laiterie	NC
laitiers	ADJ
laitière	ADJ
laitières	ADJ
lambris	NC
lancement	NC
lancer	VINF
lancinant	ADJ
lancé	VPP
lancée	VPP
langage	NC
langue	NC
lançait	V
laquelle	PROREL
large	ADJ
large	NC
largement	ADV
larvée	ADJ
latitudes	NC
laxiste	ADJ
le	CLO
le	DET
le_plus	ADV
le_plus_possible	ADV
le_plus_souvent	ADV
leader	ADJ
leader	NC
lecteur	NC
lecteurs	NC
lecture	NC
lendemain	NC
lent	ADJ
lente	ADJ
lentement	ADV
lequel	PROREL
les	CLO
les	DET
lesdits	ADJ
lesquelles	PROREL
lesquels	PROREL
lesquels	PROWH
lessive	NC
lettre	NC
leur	CLO
leur	DET
leurs	DET
lever	VINF
levé	VPP
leçons	NC
liberté	NC
libre	ADJ
libres	ADJ
libéral	ADJ
libérale	ADJ
libéralisation	NC
libéralisme	NC
libéralisés	VPP
libération	NC
libérer	VINF
licence	NC
licenciement	NC
licenciements	NC
licencient	V
licencier	VINF
liens	NC
lieu	NC
lieux	NC
ligaments	NC
ligne	NC
lignes	NC
limitant	VPR
limitations	NC
limite	NC
limiter	VINF
limites	NC
limité	VPP
limitée	ADJ
limitée	VPP
limitées	ADJ
limitées	VPP
liquidation	NC
liquide	ADJ
liquide	V
liquider	VINF
lire	NC
lire	VINF
listes	NC
lit	NC
litres	NC
littorales	ADJ
livraison	NC
livre	NC
livrent	V
livrer	VINF
livres	NC
livrets	NC
lié	ADJ
lié	VPP
liée	VPP
liés	VPP
lobbies	NC
lobby	NC
locales	ADJ
locatif	ADJ
locaux	ADJ
logement	NC
logements	NC
loger	VINF
logique	NC
logistique	NC
loi	NC
loin_d'	P
loin_de	P
lointain	ADJ
lois	NC
loisir	NC
long	ADJ
longtemps	ADV
longue	ADJ
longue_durée	ADJ
longues	ADJ
lors_d'	P
lors_de	P
lors_des	P
lorsqu'	CS
lorsque	CS
louable	ADJ
lourd	ADJ
lourde	ADJ
lourds	ADJ
loué	VPP
loyauté	NC
loyer	NC
loyers	NC
lucratifs	ADJ
lui	CLO
lui	PRO
lui_-_même	PRO
lundi	NC
lutte	NC
lutter	VINF
luttes	NC
luxe	NC
luxembourgeois	ADJ
luxembourgeoise	ADJ
lyonnais	ADJ
lyonnaise	ADJ
lyonnaise	NC
là	ADV
là_-_bas	ADV
légales	ADJ
législateur	NC
législature	NC
légitimité	NC
légume	NC
légèrement	ADV
légères	ADJ
m'	CLO
machinal	ADJ
machine	NC
machine_-_outil	NC
macro-	PREF
magasins	NC
magazine	NC
magazines	NC
magistrat	NC
magnétoscope	NC
mai	NC
maillage	NC
maillon	NC
main	NC
main_-_d'_oeuvre	NC
mainmise	NC
mains	NC
maintenance	NC
maintenant	ADV
maintenant	VPR
maintenir	VINF
maintenue	VPP
maintien	NC
maintient	V
maires	NC
mairie	NC
mais	ADV
mais	CC
maison	ADJ
maison	NC
maison_-_mère	NC
maisons	NC
majeurs	ADJ
majoration	NC
majorisme	NC
majoritaire	ADJ
majorité	NC
majorée	VPP
mal	ADJ
mal	ADV
mal	NC
mal_à_l'_aise	ADJ
malade	ADJ
malades	NC
maladie	NC
maladies	NC
malchance	NC
malgré	P
malheureusement	ADV
malins	ADJ
mandant	NC
mandants	NC
mandat	NC
mandataires	NC
mandats	NC
manifestant	NC
manifestants	NC
manifestation	NC
manifestations	NC
manifeste	NC
manifeste	V
manifesté	VPP
manière	NC
manoeuvre	NC
manque	V
manquements	NC
manqué	VPP
manufacturés	ADJ
marchand	ADJ
marchand	NC
marchande	ADJ
marchandises	NC
marchands	ADJ
marchands	NC
marche	NC
marché	NC
marchés	NC
mardi	NC
marge	NC
marges	NC
marginalisée	VPP
marin	ADJ
marins	NC
maritime	ADJ
maritimes	ADJ
maritimité	NC
mark	NC
marks	NC
marque	NC
marque	V
marquer	VINF
marqueront	V
marques	NC
mars	NC
marseillaise	ADJ
marée	NC
masquer	VINF
masse	NC
massif	NC
massivement	ADV
maternelle	ADJ
matin	ADV
matin	NC
matinée	NC
matières	NC
maturation	NC
maturité	NC
matériel	NC
mauvais	ADJ
mauvaises	ADJ
maximale	ADJ
maximiser	VINF
maximum	NC
maîtrise	NC
maîtrisent	V
maîtriser	VINF
maîtrisé	VPP
maïs	NC
me	CLO
meilleur	ADJ
meilleure	ADJ
meilleures	ADJ
meilleurs	ADJ
meilleurs	NC
membre	NC
membres	ADJ
menace	NC
menacés	ADJ
menacés	VPP
menaçant	VPR
mendiants	NC
mener	VINF
mensualisée	VPP
mensuel	ADJ
mensuelle	ADJ
mensuels	ADJ
mentalités	NC
menteur	NC
menton	NC
menée	VPP
menées	VPP
mer	NC
mercredi	NC
message	NC
mesure	NC
mesurent	V
mesures	NC
met	V
mettant	VPR
mettent	V
mettra	V
mettre	VINF
mettre_fin	VINF
meubler	VINF
mexicain	ADJ
mi_-_Novembre	NC
mi_-_décembre	NC
mi_-_journée	NC
mi_-_juin	NC
mi_-_novembre	NC
micro-	PREF
micros	NC
midi	NC
mieux	ADV
milieux	NC
militaire	ADJ
militaires	ADJ
militant	NC
mille	DET
mille_cent_cinquante_-_six	DET
milliard	NC
milliards	NC
milliers	NC
million	NC
millions	NC
mimétisme	NC
minime	ADJ
minimiser	VINF
minimum	ADJ
minimum_-_vieillesse	NC
ministre	NC
ministres	NC
ministère	NC
ministère	NPP
ministères	NC
ministériels	ADJ
minoritaires	ADJ
minérales	ADJ
miracle	ADJ
miracle	NC
mis	VPP
mise	NC
mise	VPP
mise_en_vente	NC
mises	NC
mission	NC
mistigri	NC
mitigé	ADJ
mixte	ADJ
mixtes	ADJ
mobilisé	VPP
mobilisés	VPP
mobilité	NC
mobilières	ADJ
modalités	NC
moderniser	VINF
modes	NC
modestie	NC
modification	NC
modifier	VINF
modifié	VPP
modulée	VPP
modèle	NC
modèles	NC
modéliser	VINF
modération	NC
modérée	ADJ
moeurs	NC
moi	PRO
moindre	ADJ
moins	ADV
moins	NC
moins_-_values	NC
moins_d'	P
mois	NC
moitié	NC
moment	NC
monde	NC
monde	NPP
mondial	ADJ
mondiale	ADJ
mondiales	ADJ
monnaie	NC
monopole	NC
montage	NC
montages	NC
montant	NC
montent	V
monter	VINF
montrant	VPR
montre	V
montrent	V
montré	VPP
montrés	VPP
monts_-_de_-_piété	NC
monté	VPP
montée	ADJ
montée	NC
monuments	NC
monétaire	ADJ
moque	V
moquette	NC
moral	NC
moratoire	NC
mortel	ADJ
morts	NC
mot	NC
motion	NC
motivée	VPP
motor	NC
mots	NC
moule	NC
mouture	NC
mouvement	NC
mouvements	NC
moyen	ADJ
moyen	NC
moyenne	ADJ
moyens	NC
multilatérales	ADJ
multimédias	ADJ
multinationale	NC
multiples	ADJ
multiplication	NC
multiplient	V
multiplier	VINF
municipal	ADJ
muré	VPP
musique	NC
mutation	NC
mutisme	NC
mutuels	ADJ
mystérieux	ADJ
mythe	NC
mâchoires	NC
mène	V
mécanisme	NC
mécontentement	NC
médecine	NC
médecins	NC
média	NC
médias	NC
médiatique	ADJ
médiatisation	NC
médicale	ADJ
médicalement	ADV
médicaux	ADJ
médiocrement	ADV
méfiance	NC
méfient	V
mégawatts	NC
ménage	NC
ménages	NC
méprisant	ADJ
méridionale	ADJ
méridionaux	ADJ
mérite	NC
mérite	V
méritoire	ADJ
métallurgie	NC
méthode	NC
métier	NC
métiers	NC
métropoles	NC
météorologiques	ADJ
mêlaient	V
même	ADJ
même	ADV
même	CC
même_si	CS
mêmes	ADJ
n	NC
n'	ADV
naguère	ADV
national	ADJ
national	ET
nationale	ADJ
nationales	ADJ
nationalisations	NC
nationalisé	VPP
nationalisées	VPP
nationaux	ADJ
nature	NC
ne	ADV
ne_pas	ADV
ne_plus	ADV
net	ADJ
nette	ADJ
nettement	ADV
nettement_plus	ADV
neuf	ADJ
neutre	ADJ
neutres	ADJ
ni	ADV
ni	CC
ni_-_ni	NC
nier	VINF
nippon	ADJ
nippons	ADJ
niveau	NC
niveaux	NC
noble	ADJ
noir	ADJ
nom	NC
nombre	NC
nombre_de	DET
nombre_de	P
nombreuses	ADJ
nombreux	ADJ
nomination	NC
nominations	NC
nommer	VINF
nommé	VPP
nommés	VPP
non	ADV
non	PREF
non-	PREF
non_plus	ADV
non_seulement	ADV
nord	NC
norias	NC
normal	ADJ
normale	ADJ
normalement	ADV
normande	ADJ
normes	NC
nos	DET
notables	ADJ
notables	NC
notamment	ADV
note	NC
note	V
notent	V
notes	NC
notifiés	VPP
notion	NC
notions	NC
notre	DET
nouer	VINF
nous	CLO
nous	CLS
nouveau	ADJ
nouveaux	ADJ
nouveaux	NC
nouvel	ADJ
nouvelle	ADJ
nouvelle	NC
nouvelles	ADJ
novembre	NC
nuisible	ADJ
nul	DET
nulle	ADJ
nulle_part	ADV
numéro	NC
nunuche	ADJ
nécessaire	ADJ
nécessaires	ADJ
nécessitait	V
nécessite	V
nécessitent	V
nécessité	NC
néerlandais	ADJ
nées	ADJ
négatif	ADJ
négatifs	ADJ
négative	ADJ
négligeait	V
négligence	NC
négliger	VINF
négligé	VPP
négociation	NC
négociations	NC
négocier	VINF
négocié	VPP
négociée	VPP
néo-	PREF
nés	VPP
objectif	NC
objectifs	NC
objet	NC
obligataire	ADJ
obligation	NC
obligations	NC
obligeait	V
obligé	VPP
obligés	VPP
obscénité	NC
observateur	NC
observatoire	NC
observer	VINF
observé	VPP
obstacle	NC
obsèdent	V
obtenir	VINF
obtenu	VPP
obtiendra	V
obésité	NC
occasion	NC
occasions	NC
occidental	ADJ
occidentaux	ADJ
occlusion	NC
occupants	NC
occupe	V
occupent	V
occuper	VINF
occupé	ADJ
occupé	VPP
occupée	VPP
occupés	VPP
octobre	NC
octroi	NC
oeil	NC
oeufs	NC
oeuvrant	VPR
oeuvre	NC
of	ET
offensive	NC
offerte	VPP
offertes	VPP
officialisé	VPP
officiel	ADJ
officielle	ADJ
officiellement	ADV
offre	NC
offre	V
offres	NC
offrir	VINF
oléagineuses	ADJ
oléagineux	NC
ombrage	NC
omission	NC
on	CLS
ont	V
onze	ADJ
onze	DET
opinion	NC
oppose	V
opposer	VINF
opposition	NC
opposées	ADJ
opposées	VPP
optimiste	ADJ
optimistes	ADJ
optique	NC
opté	VPP
opérateur	NC
opérateurs	NC
opération	NC
opérationnels	NC
opérations	NC
opérer	VINF
orbite	NC
ordinateur	NC
ordinateurs	NC
ordonné	VPP
ordre	NC
organe	NC
organisant	VPR
organisation	NC
organisations	NC
organise	V
organiser	VINF
organisera	V
organisme	NC
organismes	NC
organisé	ADJ
organisé	VPP
organisée	VPP
organisées	VPP
orientale	ADJ
orientation	NC
orientations	NC
original	ADJ
origine	NC
origine	V
orthodoxes	ADJ
ou	CC
oublier	VINF
oublié	VPP
oui	ADV
ours	NC
outil	NC
outils	NC
outre	P
outre_-_Atlantique	NPP
outre_-_mer	ADV
outre_mesure	ADV
ouvert	VPP
ouverture	NC
ouvrage	NC
ouvrages	NC
ouvre	V
ouvrier	ADJ
ouvrier	NC
ouvriers	NC
ouvrir	VINF
ouvrières	ADJ
où	ADVWH
où	PROREL
où	PROWH
page	NC
pages	NC
paie	NC
paie	V
paiement	NC
paiements	NC
paix	NC
palais	NC
palette	NC
panel	NC
panique	NC
panorama	NC
papetier	ADJ
papetière	NC
par	P
par_ailleurs	ADV
par_définition	ADV
par_exemple	ADV
par_l'_entremise_de	P
par_l'_intermédiaire_d'	P
par_la_suite	ADV
par_rapport_au	P
par_rapport_aux	P
par_rapport_à	P
parachuté	VPP
parachèvement	NC
paradoxale	ADJ
paradoxalement	ADV
paradoxe	NC
paraissent	V
paralyser	VINF
paraît	V
paraître	VINF
parc	NC
parce_qu'	CS
parce_que	CS
parcellisation	NC
parcours	NC
pare_-_brise	NC
pareil	ADJ
pareille	ADJ
parenthèses	NC
parents	NC
parfaite	ADJ
parfaitement	ADV
parfois	ADV
parisien	ADJ
parisienne	ADJ
parisiens	ADJ
parité	NC
parités	NC
parlaient	V
parlant	VPR
parle	V
parlementaire	ADJ
parlementaires	ADJ
parlementaires	NC
parlent	V
parler	VINF
parlé	VPP
parmi	P
parole	NC
parquet	NC
parraine	V
part	NC
partage	NC
partager	VINF
partagé	VPP
partant	NC
partenaire	NC
partenaires	NC
parti	NC
partial	ADJ
participants	ADJ
participation	NC
participations	NC
participèrent	V
participé	VPP
particularisme	NC
particuliers	NC
particulièrement	ADV
particulières	ADJ
partie	NC
partiel	ADJ
partiellement	ADV
partielles	ADJ
parties	NC
partir	VINF
partis	NC
partisans	NC
parts	NC
paru	VPP
parvenir	VINF
parviennent	V
pas	ADV
pas_encore	ADV
pas_moins	ADV
passage	NC
passagers	NC
passe	V
passe_-_partout	ADJ
passent	V
passer	VINF
passera	V
passerait	V
passif	ADJ
passif	NC
passé	ADJ
passé	NC
passé	VPP
passées	ADJ
passées	VPP
patrimoine	NC
patron	NC
patronal	ADJ
patronales	ADJ
patronat	NC
patronaux	ADJ
patrons	NC
paupérisation	NC
pauvres	ADJ
pauvreté	NC
payer	VINF
payiez	V
pays	NC
paysage	NC
paysans	NC
payé	VPP
peau	NC
peaux	NC
peluche	NC
penche	V
pencher	VINF
pencheront	V
pendant	P
pensaient	V
pensait	V
penser	VINF
pension	NC
pensionnés	NC
pensions	NC
pensée	NC
pensée	VPP
perception	NC
percée	NC
perd	V
perdre	VINF
perds	V
perdu	VPP
perdues	ADJ
performance	NC
performances	NC
performante	ADJ
performants	ADJ
perle	NC
permanente	ADJ
permet	V
permettant	VPR
permettra	V
permettre	VINF
permis	NC
permis	VPP
permis_de_conduire	NC
permis_de_construire	NC
permutations	NC
perpétuer	VINF
persistants	ADJ
personnages	NC
personnalisé	ADJ
personnalité	NC
personne	NC
personne	PRO
personnel	NC
personnels	NC
personnes	NC
perspective	NC
perspectives	NC
perte	NC
pertes	NC
perturbée	VPP
perturbées	VPP
perverse	ADJ
perversions	NC
pervertissent	V
perçues	VPP
pesante	ADJ
pesanteurs	NC
peser	VINF
peseta	NC
petit	ADJ
petite	ADJ
petits	ADJ
peu	ADV
peur	NC
peut	V
peut_-_être	ADV
peuvent	V
phares	NC
pharmacie	NC
phase	NC
physiques	ADJ
phénomène	NC
phénomènes	NC
picorer	VINF
pige	V
pilier	NC
piller	VINF
pilotes	NC
pinceaux	NC
pire	NC
pièce	NC
pièces	NC
piège	NC
place	NC
place	V
placer	VINF
places	NC
plafond	NC
plaidant	VPR
plaide	V
plaint	V
plainte	NC
plaisir	NC
plan	NC
planification	NC
plans	NC
plaque	NC
plateau	NC
plein_de_risques	ADJ
pleinement	ADV
plier	VINF
plume	NC
pluri-	PREF
plus	ADV
plus	P
plus_-_value	NC
plus_-_values	NC
plus_d'	P
plus_de	P
plus_ou_moins	ADV
plus_que	ADV
plusieurs	ADJ
plusieurs	DET
plutôt	ADV
plutôt_qu'	CS
pneus	NC
po	NC
poids	NC
poignard	NC
point	NC
pointe	NC
pointent	V
points	NC
poker	NC
policier	ADJ
policières	ADJ
politique	ADJ
politique	NC
politiquement	ADV
politiques	ADJ
politiques	NC
polonais	ADJ
polonaise	ADJ
polytechnicien	NC
ponctuelles	ADJ
pondent	V
pool	NC
popiwek	NC
popularisation	NC
population	NC
port	NC
portait	V
portant	VPR
porte	V
porte	VS
porte_parole	NC
portefeuilles	NC
porter	VINF
portera	V
porteurs	ADJ
portrait	NC
ports	NC
porté	VPP
portée	VPP
posait	V
pose	V
poser	VINF
poserait	V
positif	ADJ
positifs	ADJ
position	NC
positionnement	NC
positions	NC
positive	ADJ
possession	NC
possibilité	NC
possible	ADJ
possible	NC
possibles	ADJ
possède	V
possédait	V
poste	NC
postes	NC
postiers	NC
postulats	NC
postérieures	ADJ
posé	ADJ
posée	VPP
potentialités	NC
potentiel	NC
potentiels	ADJ
potentiels	NC
poudre	NC
poupe	NC
pour	P
pour_l'_essentiel	ADV
pour_la_première_fois	ADV
pour_le_moment	ADV
pour_le_reste	ADV
pour_qu'	CS
pour_que	CS
pourcentage	NC
pourfendre	VINF
pourparlers	NC
pourquoi	CS
pourra	V
pourraient	V
pourrait	V
pourront	V
poursuit	V
poursuite	NC
poursuivaient	V
poursuivi	VPP
poursuivie	VPP
poursuivons	V
poursuivraient	V
poursuivre	VINF
pourtant	ADV
pourvoir	VINF
pousse	V
poussiéreuse	ADJ
pouvaient	V
pouvait	V
pouvoir	NC
pouvoir	VINF
pouvoirs	NC
prairie	NC
pratique	V
pratiquement	ADV
pratiquent	V
pratiques	ADJ
pratiqués	VPP
premier	ADJ
premiers	ADJ
première	ADJ
premières	ADJ
prenaient	V
prenait	V
prenant	VPR
prend	V
prendra	V
prendre	VINF
prendre_le_relais	VINF
prenne	VS
prennent	V
prennent	VS
presque	ADV
pressante	ADJ
presse	NC
presseraient	V
pression	NC
pressions	NC
pressurées	VPP
prestations	NC
prestigieuse	ADJ
preuve	NC
preuves	NC
prime	NC
primes	NC
principal	ADJ
principal	NC
principale	ADJ
principalement	ADV
principales	ADJ
principaux	ADJ
principe	NC
printemps	NC
prions	V
prioritaire	ADJ
priorité	NC
pris	ADJ
pris	VPP
pris_fin	VPP
prise	NC
prise	VPP
prise_de_contrôle	NC
prises	NC
privatisables	ADJ
privatisation	NC
privatisations	NC
privatisé	VPP
privilégié	ADJ
privé	ADJ
privé	VPP
privée	ADJ
privées	ADJ
privés	ADJ
privés	VPP
prix	NC
probable	ADJ
probablement	ADV
problème	NC
problèmes	NC
processus	NC
prochain	ADJ
prochaine	ADJ
prochainement	ADV
prochaines	ADJ
prochains	ADJ
proche	ADJ
proches	ADJ
procurant	VPR
procède	V
procéder	VINF
procédure	NC
procédé	NC
procédé	VPP
producteur	NC
producteurs	NC
productif	ADJ
production	NC
productions	NC
productivité	NC
productrice	NC
produire	VINF
produit	NC
produite	VPP
produits	NC
profession	NC
professionnalisation	NC
professionnalisme	NC
professionnel	ADJ
professionnel	NC
professionnelles	ADJ
professionnels	ADJ
professionnels	NC
professions	NC
profil	NC
profit	NC
profiter	VINF
profits	NC
profité	VPP
programmables	ADJ
programmation	NC
programme	NC
programmes	NC
progresse	V
progressent	V
progresser	VINF
progresseront	V
progression	NC
progressive	ADJ
progressivité	NC
progressé	VPP
progrès	NC
projet	NC
projets	NC
prolongation	NC
promesses	NC
promet	V
promettant	VPR
promis	VPP
promoteur	NC
promoteurs	NC
promotion	NC
promouvoir	VINF
prononcé	VPP
prononcée	VPP
prononcés	VPP
pronostiquait	V
propos	NC
propose	V
proposer	VINF
proposera	V
proposition	NC
propositions	NC
proposé	VPP
proposée	VPP
proposées	VPP
propre	ADJ
proprement	ADV
propres	ADJ
propriétaires	NC
propriété	NC
protagonistes	NC
protection	NC
protestataires	NC
protestent	V
protester	VINF
prothèse	NC
protocole	NC
protéger	VINF
protégés	VPP
prouve	V
prouver	VINF
prouvées	VPP
provenance	NC
provenant	VPR
proviendra	V
proviendraient	V
province	NC
provisoire	ADJ
provisoirement	ADV
provisoires	ADJ
provocateur	ADJ
provoquait	V
provoque	V
provoquer	VINF
provoqué	VPP
proximité	NC
près_d'	P
près_de	P
pré-	PREF
préalable	ADJ
préalable	NC
préalablement	ADV
préambule	NC
précis	ADJ
précisait	V
précisant	VPR
précise	V
préciser	VINF
précises	ADJ
précisions	NC
précisé	VPP
préconisé	VPP
précédant	VPR
précédemment	ADV
précédent	ADJ
précédente	ADJ
précédentes	ADJ
prédominance	NC
prédécesseur	NC
préfecture	NC
préfectures	NC
préfets	NC
préfèreront	V
préférables	ADJ
préférences	NC
préférerait	V
préféreriez	V
préjudiciable	ADJ
préjugés	NC
préliminaire	ADJ
prélude	NC
préluder	VINF
préoccupant	VPR
préoccupation	NC
préoccupent	V
prépare	V
préparé	VPP
préqualification	NC
préretraite	NC
prérogatives	NC
présence	NC
présent	ADJ
présentait	V
présentateurs	NC
présentation	NC
présente	ADJ
présente	V
présentent	V
présenter	VINF
présenté	VPP
présentée	VPP
préserver	VINF
présidaient	V
présidence	NC
président	NC
présidents	NC
présider	VINF
présidé	VPP
présidées	VPP
prétendue	ADJ
prétexte	NC
prévalu	VPP
prévenu	VPP
prévenus	NC
prévisible	ADJ
prévision	NC
prévisionnelle	ADJ
prévisions	NC
prévoir	VINF
prévoit	V
prévu	VPP
prévues	ADJ
prévus	VPP
prêt	ADJ
prêt	NC
prêtait	V
prête	ADJ
prêter	VINF
prêteurs	NC
prêts	NC
psychologiques	ADJ
psychologues	NC
pu	VPP
pub	NC
public	ADJ
public	NC
publication	NC
publicité	NC
publics	ADJ
publier	VINF
publique	ADJ
publiques	ADJ
publié	VPP
publiée	VPP
puis	ADV
puis	CC
puise	V
puisqu'	CS
puisque	CS
puissance	NC
puissant	ADJ
puissants	ADJ
puisse	VS
puissent	VS
pure	ADJ
put	V
pâtit	V
pèlerins	NC
pères	NC
pèse	V
pèsent	V
pédagogie	NC
pédagogique	ADJ
pédagogiques	ADJ
pédiatrie	NC
pénalisés	VPP
péniche	NC
péniches	NC
pénétrer	VINF
périgourdin	ADJ
péril	NC
périlleuse	ADJ
période	NC
périodes	NC
pétrole	NC
pétroliers	NC
pétrolifères	ADJ
pêche	NC
pêches	NC
qu'	ADV
qu'	CS
qu'	PROREL
quadriller	VINF
quai	NC
qualification	NC
qualifié	VPP
qualifiée	ADJ
qualifiée	VPP
qualitatif	ADJ
qualité	NC
quand	CS
quand_même	ADV
quant_à	P
quantitative	ADJ
quarantaine	NC
quarante	DET
quarante_-_cinq	DET
quarante_-_deux	DET
quarante_-_huit	DET
quarante_-_huit	PRO
quarante_-_trois	DET
quartier	NC
quartiers	NC
quasi-	PREF
quasiment	ADV
quatorze	DET
quatre	ADJ
quatre	DET
quatre	PRO
quatre_-_vingts	DET
quatre_cents	DET
quatre_mille	DET
quatrième	ADJ
que	ADV
que	CS
que	PROREL
que	PROWH
que_si	ADV
quelle	ADJWH
quelle	DETWH
quelqu'_un	PRO
quelque	ADJ
quelque	ADV
quelque	DET
quelques	DET
quels	DETWH
querelles	NC
question	NC
questions	NC
qui	PROREL
qui	PROWH
qui_plus_est	ADV
quinze	ADJ
quinze	DET
quitte	V
quitte_à	P
quitter	VINF
quo	ET
quoi	PROWH
quota	NC
quotas	NC
quotidien	ADJ
quotidien	NC
quotidienne	ADJ
quotidiens	NC
rabais	NC
rachat	NC
rachats	NC
rachetant	VPR
racheté	VPP
racontait	V
radio	NC
radoub	NC
raffermissant	VPR
raffolent	V
ragaillardi	VPP
raid	NC
rail	NC
raison	NC
raisonnables	ADJ
raisons	NC
raisons_d'_être	NC
ralentie	VPP
ralenties	VPP
ralentissement	NC
ramener	VINF
ramené	VPP
ramenée	VPP
ramène	V
rang	NC
ranimer	VINF
rapide	ADJ
rapidement	ADV
rapides	ADJ
rappel	NC
rappeler	VINF
rappelle	V
rapport	NC
rapprochement	NC
rapprocher	VINF
rares	ADJ
ras_-_le_-_bol	NC
rassemblait	V
rassembler	NC
rassure	V
rassurent	VS
ratifié	VPP
rationaliser	VINF
ratisser	VINF
rattrapage	NC
ravages	NC
ravis	ADJ
rayonner	VINF
rebaptisé	VPP
rebelles	NC
rebond	NC
rebut	NC
rebutés	VPP
recette	NC
recettes	NC
recevaient	V
recevoir	VINF
recherche	NC
recherche	V
recherches	NC
reclasse	V
reclassement	NC
recommandait	V
recommençaient	V
reconduction	NC
reconductions	NC
reconduit	VPP
reconduits	VPP
reconnaissance	NC
reconnaissent	V
reconnaître	VINF
reconnu	VPP
reconstruction	NC
reconstruire	VINF
reconversions	NC
record	ADJ
records	NC
recours	NC
recruter	VINF
rectificative	ADJ
rectifie	V
recueillis	VPP
redescendre	VINF
rediffusion	NC
redonne	V
redonnent	V
redoutent	V
redresse	V
redressement	NC
redresser	VINF
redécollage	NC
redécouvre	V
redémarrage	NC
refait	V
referme	V
refonte	NC
refus	NC
refusait	V
refusant	VPR
refuse	V
refusent	V
refuser	VINF
refusé	VPP
refusée	NC
regain	NC
regardant	VPR
regardent	V
regarder	VINF
regarderont	V
regrettable	ADJ
regrette	V
regretter	VINF
regroupement	NC
rejet	NC
rejetant	VPR
rejette	V
rejeté	VPP
rejoindre	VINF
relance	NC
relancent	V
relancer	VINF
relate	V
relation	NC
relations	NC
relative	ADJ
relativement	ADV
relaxer	VINF
relaxé	VPP
relayées	VPP
relents	NC
relevant	VPR
relevé	VPP
relève	NC
relève	V
remarquer	VINF
remboursables	ADJ
remboursement	NC
remboursements	NC
remercié	VPP
remettre	VINF
remirent	V
remontent	V
remonter	VINF
remontée	NC
rempiler	VINF
remplace	V
remplacer	VINF
remplacé	VPP
remplaçaient	V
remplir	VINF
remplis	VPP
remplissage	NC
remporté	VPP
remue_-_ménage	NC
rencontre	NC
rencontrer	VINF
rencontres	NC
rend	V
rendant	VPR
rendement	NC
rendements	NC
rendent	V
rendez_-_vous	NC
rendraient	V
rendrait	V
rendre	VINF
rendu	VPP
rendue	VPP
rendues	ADJ
renforce	V
renforcer	VINF
renforçant	VPR
renommé	VPP
renoncé	VPP
renonçant	VPR
renouant	VPR
renouveler	VINF
renouvellement	NC
renouvellements	NC
renouvelé	VPP
renouvelée	VPP
renouvelés	VPP
rentabilisé	VPP
rentabilité	NC
rentable	ADJ
rente	NC
rentrer	VINF
rentrées	NC
renvoient	V
renvoyé	VPP
repart	V
replier	VINF
repointent	V
repose	V
reposent	V
repousser	VINF
repoussé	VPP
reprenant	VPR
reprend	V
reprendre	VINF
repreneur	NC
reprennent	V
repris	VPP
reprise	NC
reprise	VPP
reproche	NC
reproche	V
représentait	V
représentant	VPR
représentants	NC
représentatif	ADJ
représentation	NC
représente	V
représentent	V
représenterait	V
représenteront	V
représenté	VPP
repères	NC
respect	NC
respectant	VPR
respectifs	ADJ
respectivement	ADV
responsabilité	NC
responsabilités	NC
responsable	ADJ
responsable	NC
responsables	NC
ressemblaient	V
ressort	NC
ressortir	VINF
ressources	NC
restaient	V
restant	VPR
reste	NC
reste	V
restent	V
rester	VINF
restera	V
resteront	V
restitutions	NC
restriction	NC
restructuration	NC
restructurations	NC
restée	VPP
retard	NC
retardait	V
retardé	VPP
retardée	VPP
retenir	VINF
retenue	VPP
retenues	VPP
retire	V
retirer	VINF
retombé	VPP
retombées	NC
retour	NC
retrait	NC
retraite	NC
retraites	NC
retraité	VPP
retraités	NC
retrouve	V
retrouvent	V
retrouver	VINF
retrouvé	VPP
retrouvés	VPP
revalorisation	NC
revaloriser	VINF
revalorisées	VPP
revenait	V
revendication	NC
revendications	NC
revenir	VINF
revenu	NC
revenu	VPP
revenus	NC
revenus	VPP
revers	NC
reversée	VPP
reviendrons	V
revivre	VINF
revoir	VINF
revu	VPP
revue	NC
revues	NC
revus	VPP
reçu	VPP
reçue	VPP
ribambelle	NC
riches	ADJ
richesse	NC
rien	PRO
rigide	ADJ
rigueur	NC
rire	NC
risquait	V
risque	NC
risque	V
risquent	V
risquerait	V
risques	NC
risquées	ADJ
rituel	NC
rival	NC
rivale	NC
rives	NC
robots	NC
rocardien	ADJ
rompu	VPP
ronds	ADJ
room	NC
roquefort	NC
rose	ADJ
rouble	NC
roubles	NC
round	NC
route	NC
routes	NC
routiers	ADJ
routiers	NC
ruche	NC
rude	ADJ
rumeur	NC
rumeurs	NC
rupture	NC
rurale	ADJ
ruralité	NC
ruraux	ADJ
russe	ADJ
russes	ADJ
rustique	ADJ
rythme	NC
règle	NC
règles	NC
règne	V
réaction	NC
réactions	NC
réaffirmé	VPP
réagi	VPP
réagir	VINF
réalisation	NC
réaliser	VINF
réaliseront	V
réalisme	NC
réalisé	VPP
réalisée	VPP
réalisées	VPP
réalisés	VPP
réalité	NC
réaménagement	NC
récemment	ADV
récent	ADJ
réception	NC
récession	NC
réciproques	ADJ
réclamaient	V
réclament	V
réclamer	VINF
réclamé	VPP
récompensé	VPP
récupèrent	V
récupérateurs	NC
récupération	NC
rédaction	NC
rédactions	NC
rédigé	VPP
réduction	NC
réductions	NC
réduire	VINF
réduisait	V
réduit	V
réduite	VPP
réduits	ADJ
réel	ADJ
réelle	ADJ
réels	ADJ
réflexe	NC
réflexion	NC
réforme	NC
réformes	NC
réformiste	ADJ
référence	NC
références	NC
régime	NC
régiment	NC
régimes	NC
région	NC
régional	ADJ
régionale	ADJ
régionales	ADJ
régionaux	ADJ
régions	NC
réglementation	NC
réglé	VPP
régnant	VPR
régression	NC
régulateur	ADJ
régulation	NC
régulés	VPP
réhabilitation	NC
rémunération	NC
rémunéré	ADJ
rémunéré	VPP
rénover	VINF
réorganisations	NC
répandu	VPP
réparer	VINF
réparti	VPP
répartie	VPP
répartis	VPP
répartit	V
répartition	NC
répercussions	NC
répond	V
répondrait	V
répondu	VPP
réponse	NC
répression	NC
républicain	ADJ
réputation	NC
répétitifs	ADJ
répétés	ADJ
réseau	NC
réservant	VPR
réservation	NC
réserveront	V
réserves	NC
réservé	ADJ
résidence	NC
résidu	NC
résistance	NC
résolu	VPP
résoudre	VINF
résultant	VPR
résultat	NC
résultats	NC
résultera	V
résume	V
rétabli	VPP
rétablir	VINF
réticences	NC
rétorqueront	V
rétrécissement	NC
réuni	VPP
réunification	NC
réunifiée	VPP
réunion	NC
réunions	NC
réunira	V
réunissant	VPR
réussi	VPP
réussie	ADJ
réussit	V
réussite	NC
réviser	VINF
révision	NC
révisé	VPP
révolution	NC
révèle	V
révélait	V
révéler	VINF
révélé	VPP
rééquilibrer	VINF
réévaluées	VPP
rôle	NC
s'	CLR
s'	CS
sa	DET
saccadé	ADJ
sacrifices	NC
sacrés	ADJ
saga	NC
sages	ADJ
saine	ADJ
saint_-_Gobain	NPP
sais	V
saisi	VPP
saisit	V
saison	NC
sait	V
salaire	NC
salaires	NC
salariale	ADJ
salariales	ADJ
salarié	NC
salariés	ADJ
salariés	NC
salariés	VPP
salue	V
saluer	VINF
saluée	VPP
samedi	NC
sanction	NC
sanctionner	VINF
sanglots	NC
sans	ADV
sans	P
sans_-_abri	NC
sans_cesse	ADV
sans_doute	ADV
sans_qu'	CS
santé	NC
satisfaction	NC
satisfaisant	ADJ
satisfait	ADJ
sauf	P
saurait	V
saut	NC
sauter	VINF
sauvegarde	NC
sauvetage	NC
savait	V
savant	ADJ
savoir	NC
savoir	VINF
savoir_-_faire	NC
savoirs	NC
scandale	NC
scandales	NC
scandinave	ADJ
sciemment	ADV
science	NC
scientifique	ADJ
scier	VINF
scolaire	ADJ
score	NC
scrupuleux	ADJ
scène	NC
scénario	NC
scénarios	NC
se	CLR
second	ADJ
seconde	ADJ
seconde	NC
secouer	VINF
secours	NC
secousses	NC
secrétaire	NC
secteur	NC
secteurs	NC
section	NC
sein	NC
seize	DET
selon	P
semaine	NC
semaines	NC
semblables	ADJ
semble	V
semblent	V
sembler	VINF
semestre	NC
semestrielle	ADJ
sens	NC
sensibilités	NC
sensible	ADJ
sensiblement	ADV
sent	V
sentent	V
sentiment	NC
sentiments	NC
sentir	VINF
sept	ADJ
sept	DET
septembre	NC
sera	V
seraient	V
serait	V
seront	V
sert	V
servant	VPR
servent	V
service	NC
services	NC
servir	VINF
servira	V
ses	DET
session	NC
seuil	NC
seul	ADJ
seule	ADJ
seulement	ADV
seules	ADJ
sexes	NC
sextant	NC
show	NC
si	ADV
si	CS
si_possible	ADV
sidère	V
sidérurgie	NC
sidérurgiques	ADJ
signale	V
signalé	VPP
signant	VPR
signataires	NC
signatures	NC
signe	NC
signer	VINF
signes	NC
signifiant	VPR
significative	ADJ
signifie	V
signifierait	V
signé	VPP
simple	ADJ
simplement	ADV
simplificateurs	ADJ
simplification	NC
simplifier	VINF
simplifiée	VPP
sine_die	ADV
singulièrement	ADV
sinistrée	ADJ
sit_-_in	NC
site	NC
situant	VPR
situation	NC
situations	NC
situe	V
situer	VINF
situées	VPP
situés	VPP
six	ADJ
six	PRO
siècle	NC
siècles	NC
ski	NC
social	ADJ
sociale	ADJ
sociales	ADJ
socialisation	NC
socialisme	NC
socialiste	ADJ
socialistes	ADJ
socialistes	NC
sociaux	ADJ
socio_-_professionnelles	ADJ
sociologue	NC
sociologues	NC
société	NC
sociétés	NC
soi	PRO
soient	VS
soigner	VINF
soir	ADV
soir	NC
soirée	NC
soit	ADV
soit	CC
soit	P
soit	VS
soixante_-_cinq	DET
soixante_-_neuf	DET
soixante_-_sept	DET
soixante_-_six	DET
soixante_-_trois	DET
solde	NC
soldes	NC
solidaire	ADJ
solidaires	ADJ
solidarité	NC
solides	ADJ
sollicitations	NC
sollicité	VPP
solution	NC
sombre	ADJ
sombrer	VINF
somme	NC
sommeil	NC
sommes	NC
sommes	V
sommet	NC
son	DET
sondage	NC
sondages	NC
sondés	NC
songerait	V
sont	V
sophistiqué	ADJ
sorcières	NC
sort	NC
sort	V
sorti	VPP
souci	NC
soucieuses	ADJ
soucieux	ADJ
soudaine	ADJ
souffler	VINF
souffre	V
souhaitable	ADJ
souhaitait	V
souhaite	V
souhaitent	V
souhaité	VPP
souhaitées	VPP
soulevée	VPP
souligne	V
soulignent	V
souligner	VINF
souligné	VPP
soumettre	VINF
soumettront	V
soumis	VPP
soumission	NC
souple	ADJ
soupçonner	VINF
soupçonnés	VPP
source	NC
sourds	ADJ
sourds	NC
sournois	ADJ
sous	P
sous_-_estimer	VINF
sous_-_jacentes	ADJ
sous_-_préfecture	NC
sous_-_préfectures	NC
sous_-_traitance	NC
sous_-_évaluation	NC
sous_-_évalué	VPP
sous_forme_d'	P
sous_forme_de	P
sous_l'_impulsion_de	P
sous_la_direction_de	P
souscrit	VPP
soutenir	VINF
soutenu	ADJ
soutenue	ADJ
soutien	NC
souvenirs	NC
souvent	ADV
soviétique	ADJ
spectacle	NC
spectaculaire	ADJ
spectaculaires	ADJ
sphère	NC
spontanées	ADJ
spontanément	ADV
sportives	ADJ
spécial	ADJ
spéciale	ADJ
spécialisation	NC
spécialisé	VPP
spécialisée	ADJ
spécialisées	ADJ
spécialisés	ADJ
spécifique	ADJ
spécifiques	ADJ
spéculation	NC
stabilisation	NC
stabilisé	VPP
stabilité	NC
stable	ADJ
stables	ADJ
stade	NC
stage	NC
stagnante	ADJ
standards	NC
state	ET
stations	NC
statistique	ADJ
statistique	NC
statistiquement	ADV
statistiques	NC
statu	ET
statuait	V
statut	NC
statutaires	ADJ
sterling	ET
stimuler	VINF
stock	NC
stocker	VINF
stocks	NC
stratégie	NC
stratégies	NC
stratégiques	ADJ
stresser	VINF
strict	ADJ
structure	NC
structurer	VINF
structurée	ADJ
studios	NC
stupidité	NC
stupéfie	V
su	VPP
subir	VINF
subira	V
subitement	ADV
subodorent	V
subsidiarité	NC
subsiste	V
subtil	ADJ
subvention	NC
subventions	NC
successeur	NC
successifs	ADJ
succession	NC
successivement	ADV
successives	ADJ
succède	V
succès	NC
succéder	VINF
sud_-_ouest	NPP
suffi	VPP
suffisamment	ADV
suffisant	ADJ
suffisante	ADJ
suffisent	V
suffit	V
suffrages	NC
suggère	V
suggéré	VPP
suicides	NC
suisse	ADJ
suit	V
suite	NC
suivant	ADJ
suivant	P
suivants	ADJ
suivi	VPP
suivie	VPP
suivirent	V
suivre	VINF
sujétion	NC
super	ADJ
supermarchés	NC
supervisent	V
superviser	VINF
supplément	NC
supplémentaire	ADJ
supplémentaires	ADJ
supporte	V
supportées	VPP
supposera	V
supposerait	V
supposée	VPP
suppression	NC
supprimant	VPR
supprime	V
supprimer	VINF
supprimerait	V
supprimé	VPP
supérieur	ADJ
supérieur	NC
supérieure	ADJ
supérieures	ADJ
supérieurs	ADJ
sur	P
sur_fond_de	P
sur_la_voie_de	P
sur_le_terrain	ADV
surcapacité	NC
surdétermination	NC
sureffectifs	NC
surenchères	NC
surface	NC
surgir	VINF
surgissent	V
surmonter	VINF
surmonté	VPP
surpris	VPP
surprise	NC
surqualification	NC
sursis	NC
surtout	ADV
surveillance	NC
survie	NC
survient	V
survivre	VINF
susceptible	ADJ
suspectés	VPP
suspendre	VINF
suspendu	VPP
suspendue	VPP
suspense	NC
suspension	NC
suédois	ADJ
sympas	ADJ
sympathies	NC
syndical	ADJ
syndicales	ADJ
syndicalisation	NC
syndicalisme	NC
syndicat	NC
syndicats	NC
synonyme	ADJ
système	NC
systèmes	NC
systématique	ADJ
séchée	VPP
sécurité	NC
sélectionna	V
séparation	NC
séquences	NC
série	NC
séries	NC
sérieuse	ADJ
sérieusement	ADV
sérieux	ADJ
sévissent	V
sévèrement	ADV
sévères	ADJ
tabac	NC
tabagisme	NC
table	NC
table	V
tableaux	NC
taille	NC
taillé	VPP
talonnant	VPR
tandis_que	CS
tankers	NC
tant	ADV
taquiner	VINF
tard	ADV
tardives	ADJ
tardé	VPP
tarifaire	ADJ
tarifs	NC
tassement	NC
taux	NC
taxation	NC
taxe	NC
taxi	NC
tchèque	ADJ
tchèques	ADJ
tchécoslovaque	ADJ
tchécoslovaques	ADJ
technicien	NC
technique	ADJ
technique	NC
techniques	ADJ
techniques	NC
technocrates	NC
technologie	NC
technologique	ADJ
tel	ADJ
telle	ADJ
telle	DET
telles	ADJ
tels	ADJ
temple	NC
temporairement	ADV
temps	NC
tempère	V
tenait	V
tenancière	NC
tenant	VPR
tendance	NC
tendances	NC
tendue	ADJ
tendus	ADJ
tension	NC
tensions	NC
tentaculaires	ADJ
tentative	NC
tentatives	NC
tente	V
tentent	VS
tenter	VINF
tenté	VPP
tenu	VPP
tenue	VPP
tenues	VPP
terme	NC
termes	NC
terminal	NC
terminée	VPP
termitière	NC
terrain	NC
terre	NC
terrestres	ADJ
territoire	NC
teste	V
tests	NC
texte	NC
textes	NC
textile	ADJ
textile	NC
thatchérien	ADJ
thromboses	NC
thème	NC
thèses	NC
thématiques	ADJ
théorie	NC
théories	NC
thérapie	NC
tiendront	V
tienne	VS
tiennent	VS
tiens	I
tient	V
tiers	NC
timide	ADJ
tire	V
tirent	V
tirer	VINF
tireront	V
titre	NC
titres	NC
titulaires	ADJ
titulaires	NC
toiles	NC
tollé	NC
tombent	V
ton	DET
torpeur	NC
tort	NC
torture	NC
total	ADJ
total	NC
totale	ADJ
totalement	ADV
totalité	NC
touchant	VPR
touche	V
touchent	V
toucher	VINF
touchera	V
touché	VPP
touchée	VPP
toujours	ADV
toujours_pas	ADV
tour	NC
tour_de_passe_-_passe	NC
tourisme	NC
touristes	NC
touristique	ADJ
touristiques	ADJ
tournant	NC
tournante	ADJ
tourner	VINF
tourné_court	VPP
tous	ADJ
tous	DET
tous	PRO
tout	ADJ
tout	ADV
tout	DET
tout	NC
tout	PRO
tout_-_petits	NC
tout_au_moins	ADV
tout_court	ADV
tout_d'_abord	ADV
tout_juste	ADV
toute	ADJ
toute	DET
toutefois	ADV
toutes	ADJ
toutes	PRO
traces	NC
tractations	NC
tracteurs	NC
trade_unions	ET
traditionnel	ADJ
traditionnelles	ADJ
traditionnels	ADJ
traduction	NC
traduit	V
traduit	VPP
trafic	NC
trafics	NC
train	NC
trait	NC
traitement	NC
traiter	VINF
traites	NC
traits	NC
traitée	VPP
traités	VPP
trajet	NC
tranche	NC
trancher	VINF
tranches	NC
transaction	NC
transactions	NC
transalpine	ADJ
transatlantique	ADJ
transfert	NC
transforment	V
transformé	VPP
transformée	VPP
transférer	VINF
transférés	VPP
transgressé	VPP
transition	NC
transmis	VPP
transparence	NC
transport	NC
transporte	V
transporter	VINF
transporteurs	NC
transports	NC
travail	NC
travaille	V
travailler	VINF
travailleurs	NC
travaillé	VPP
travaux	NC
treize	DET
trentaine	NC
trente	DET
trente_-_deux	DET
trente_-_quatre	DET
trente_-_sept	DET
trente_-_six	DET
trente_et_un	DET
tri	NC
tribunal	NC
tribut	NC
triche	V
trimestre	NC
trimestres	NC
trimestrielle	ADJ
trimestriels	ADJ
triomphalement	ADV
triomphe	NC
tripalium	ET
tripartite	ADJ
triple	ADJ
triste	ADJ
trois	ADJ
trois	DET
trois	PRO
troisième	ADJ
trompeuses	ADJ
tronqué	ADJ
trop	ADV
troubles	NC
troupeau	NC
troupeaux	NC
troupes	NC
trouve	V
trouvent	V
trouver	VINF
trouvera	V
trouvée	VPP
très	ADV
trésorerie	NC
trésors	NC
type	NC
tâche	NC
tâches	NC
télé	NC
télécommunications	NC
télédiffusion	NC
téléphone	NC
téléphoniques	ADJ
télés	NC
téléspectateur	NC
téléspectateurs	NC
téléviseur	NC
télévision	NC
télévisées	ADJ
témoignait	V
témoigne	V
témoignent	V
ténu	ADJ
têtes	NC
tôt	ADV
ultra-	PREF
ultrafrais	ADJ
ultralibéralisme	NC
un	DET
un	NC
un	PRO
un_moment	ADV
un_peu	ADV
un_peu_de	DET
un_peu_plus	ADV
unanimité	NC
une	ADJ
une	DET
une	NC
une	PRO
une_fois	ADV
une_fois_de_plus	ADV
une_fois_encore	ADV
une_sorte_d'	DET
unification	NC
unifiée	VPP
unilatéralement	ADV
union	NC
union	NPP
unique	ADJ
uniquement	ADV
unité	NC
unités	NC
univers	NC
universalité	NC
universitaire	ADJ
univoque	ADJ
urbaines	ADJ
urbains	ADJ
urgence	NC
urgente	ADJ
urgents	ADJ
usent	V
user	VINF
usine	NC
usines	NC
usure	NC
utile	ADJ
utiles	ADJ
utilisant	VPR
utilisation	NC
utilisent	V
utilisée	VPP
utilisées	VPP
utilisés	VPP
utilité	NC
va	V
vacances	NC
vacanciers	NC
vacante	ADJ
vacants	ADJ
vache	NC
vaches	NC
vague	NC
vagues	NC
vaine	ADJ
valeur	NC
valeurs	NC
vallée	NC
vallées	NC
valse	NC
valse_-_hésitation	NC
vantés	VPP
variables	ADJ
variations	NC
variée	ADJ
vaste	ADJ
vastes	ADJ
vaudra	V
veiller	VINF
veillerait	V
vend	V
vendent	V
vendeurs	NC
vendre	VINF
vendredi	NC
vendu	VPP
vendues	VPP
vendus	VPP
venir	VINF
vent	NC
vente	NC
ventes	NC
venu	VPP
venue	NC
venus	VPP
verbale	ADJ
verront	V
verrouiller	VINF
vers	P
versement	NC
versements	NC
verser	VINF
versées	VPP
versés	VPP
vertigineuses	ADJ
vertigineux	ADJ
vertébrale	ADJ
vestige	NC
veulent	V
veut	V
via	P
viande	NC
vice-	PREF
victime	ADJ
victime	NC
victoire	NC
vides	NC
vie	NC
vieille	ADJ
vieillesse	NC
viennent	V
vient	V
vieux	ADJ
vif	ADJ
vigilance	NC
vigoureuse	ADJ
vigueur	NC
villes	NC
vingt	ADJ
vingt	DET
vingt_-_cinq	ADJ
vingt_-_cinq	DET
vingt_-_huit	DET
vingt_-_quatre	ADJ
vingt_-_quatre	DET
vingt_mille	ADJ
vingtaine	NC
violemment	ADV
violence	NC
virage	NC
virulentes	ADJ
vis_-_à_-_vis_de	P
vis_-_à_-_vis_du	P
visa	NC
visage	NC
visages	NC
viscéralement	ADV
vise	V
visent	V
visera	V
visiblement	ADV
vision	NC
visite	NC
visiteurs	NC
visité	VPP
vite	ADV
vite_et_bien	ADV
vitesse	NC
vitrine	NC
vive	ADJ
vivement	ADV
vives	ADJ
vivre	VINF
vocation	NC
voeux	NC
voici	P
voie	NC
voient	V
voies	NC
voir	VINF
voire	CC
voisin	NC
voit	V
voitures	NC
vole	V
volent	V
voler	VINF
volet	NC
volontaire	ADJ
volontariat	NC
volontaristes	ADJ
volonté	NC
vols	NC
voltigeurs	NC
volume	NC
volumes	NC
vont	V
vote	NC
votent	V
voter	VINF
votes	NC
votos	ET
votre	DET
votée	VPP
voulaient	V
voulait	V
voulant	VPR
voulez	V
vouloir	NC
vouloir	VINF
voulons	V
voulu	VPP
vous	CLS
vous	PRO
voyage	NC
voyages	NC
vrai	ADJ
vraie	ADJ
vraies	ADJ
vraiment	ADV
vraisemblablement	ADV
vraisemblance	NC
vu	VPP
vue	NC
vues	VPP
vulnérable	ADJ
vus	VPP
vécu	VPP
véhicules	NC
vénérables	ADJ
vérifier	VINF
véritable	ADJ
vérité	NC
welfare	ET
world	ET
y	CLO
y_compris	ADV
yaourts	NC
yen	NC
yeux	NC
zappent	V
zapper	VINF
zapperaient	V
zapperont	V
zappeurs	NC
zapping	NC
zloty	NC
zlotys	NC
zone	NC
zones	NC
zéro	ADJ
Ça	PRO
Ça_cartoon	NPP
Égal	ADJ
Égaux	ADJ
États_-_UNIS	NPP
à	P
à_cause_de	P
à_ce_sujet	ADV
à_cet_égard	ADV
à_chaque_fois_qu'	CS
à_compter_du	P
à_concurrence_de	P
à_condition_qu'	CS
à_coup_sûr	ADV
à_destination_des	P
à_destination_du	P
à_domicile	ADV
à_grand_bruit	ADV
à_grande_échelle	ADV
à_hauteur_de	P
à_jour	ADV
à_l'_appel_de	P
à_l'_appel_des	P
à_l'_avance	ADV
à_l'_encontre_de	P
à_l'_entrée_des	P
à_l'_exception_de	P
à_l'_heure_du	P
à_l'_intention_des	P
à_l'_intérieur_de	P
à_l'_issue_de	P
à_l'_occasion_d'	P
à_l'_occasion_de	P
à_l'_occasion_du	P
à_l'_économie	ADV
à_l'_égard_de	P
à_l'_égard_du	P
à_l'_époque	ADV
à_la_baisse	ADV
à_la_base_de	P
à_la_charge_de	P
à_la_demande_de	P
à_la_différence_de	P
à_la_disposition_de	P
à_la_disposition_des	P
à_la_faveur_d'	P
à_la_fin	P
à_la_fin_de	P
à_la_fin_des	P
à_la_fin_du	P
à_la_fois	ADV
à_la_hausse	ADV
à_la_hauteur_de	P
à_la_manière_des	P
à_la_place_de	P
à_la_suite_d'	P
à_la_suite_de	P
à_la_tête_d'	P
à_la_tête_de	P
à_la_tête_des	P
à_la_tête_du	P
à_long_terme	ADJ
à_long_terme	ADV
à_moins_qu'	CS
à_même	ADJ
à_nouveau	ADV
à_partir_d'	P
à_partir_de	P
à_partir_du	P
à_peine	ADV
à_perte	ADV
à_propos_de	P
à_propos_des	P
à_répétition	ADV
à_terme	ADV
à_titre_de	P
à_travers	P
à_venir	ADV
âge	NC
âgées	ADJ
âgés	ADJ
âme	NC
âneries	NC
âpre	ADJ
âpreté	NC
ère	NC
ébahis	ADJ
écart	NC
échangeaient	V
échanger	VINF
échanges	NC
échantillon	NC
échappe	V
échec	NC
échecs	NC
échelle	NC
échéancier	NC
éclaire	V
éclate	V
éclatement	NC
école	NC
écoles	NC
écologistes	NC
économie	NC
économies	NC
économique	ADJ
économiquement	ADV
économiques	ADJ
économiser	VINF
économistes	NC
écossaise	ADJ
écoute	NC
écran	NC
écriait	V
écrit	NC
écrit	VPP
écrite	ADJ
écrivent	V
écus	NC
édition	NC
éditions	NC
éditoriale	ADJ
éditorialiste	NC
éducation	NC
égal	ADJ
égale	ADJ
également	ADV
égaler	VINF
égales	ADJ
égalité	NC
égard	NC
égoïsmes	NC
élaborerait	V
élaborés	VPP
élargir	VINF
élargissement	NC
élargit	V
élections	NC
électorale	ADJ
électrique	ADJ
électronique	ADJ
électronique	NC
élevage	NC
éleveurs	NC
élevé	ADJ
élevé	VPP
élevée	VPP
élevées	VPP
élevés	ADJ
élevés	VPP
éliminant	VPR
éliminer	VINF
élitiste	ADJ
éloquents	ADJ
élève	NC
élève	V
élèves	NC
élément	NC
éléments	NC
émergence	NC
émet	V
éminents	ADJ
émirat	NC
émission	NC
émissions	NC
énarque	NC
énergie	NC
énormes	ADJ
énormément	ADV
épaulé	VPP
épingle	NC
épisode	NC
épitaphes	NC
éponge	NC
épopée	NC
époque	NC
épousaient	V
épreuve	NC
éprouvée	VPP
épure	NC
équilibre	NC
équipe	NC
équipement	NC
équivalent	ADJ
équivalent	NC
équivaut	V
établi	VPP
établie	VPP
établir	VINF
établis	VPP
établissaient	V
établissement	NC
établissements	NC
établit	V
étaient	V
était	V
étant	VPR
étape	NC
étapes	NC
état	NC
étatique	ADJ
étatisé	VPP
étendre	VINF
étendue	VPP
étonnant	ADJ
étrange	ADJ
étranger	ADJ
étranger	NC
étrangers	ADJ
étrangers	NC
étrangère	ADJ
étrangères	ADJ
étroit	ADJ
étroit	NC
étroite	ADJ
étroitement	ADV
étude	NC
études	NC
étudier	VINF
étudierait	V
été	NC
été	VPP
évaluait	V
évalue	V
évaluer	VINF
évalués	VPP
éveil	NC
éventualité	NC
éventuel	ADJ
éventuelle	ADJ
éventuelles	ADJ
éviction	NC
évidemment	ADV
évidence	NC
évident	ADJ
évitant	VPR
éviter	VINF
éviterait	V
évolue	V
évoluer	VINF
évolution	NC
évoque	V
évoquée	VPP
événement	NC
événements	NC
être	NC
être	VINF
ô	I
